a	a
abandoned	kosundola
abandon	kotika
abide	kotosa
ability	makoki
able	kokoka
about	pene
above	likolo
abroad	na mboka mopaya
absence	kozanga koya
absent	kozala te
absolutely	bongo mpenza
absorb	komela
abstract	emonanaka te
absurd	bozoba
abundance	ebele
abundant	ebele
abuse	komonisa mpasi
accent	lolenge ya koloba
accept	kondima
access	kokota
accident	aksida
accommodation	esika ya kofanda
accomplished	kosala
accomplish	kosala
according	na kotalela
account	konte
accuracy	sikisiki
accurate	sikisiki
accused	kofunda
ache	mpasi
achieve	kokokisa
achievement	mosala
acknowledge	kondima
acquaintance	koyebana
acquired	kozwa
acquire	kozwa
acquisition	kosomba
across	na
action	mosala
active	esalaka
activities	misala
activity	mosala
act	mosala
actor	mosani
actual	ezali mpenza
actually	na koloba solo
acute	makasi
adapt	komesana
addicted	kokoma moombo
additional	mosusu
addition	kobakisa
add	kobakisa
address	adresi
adequate	ebongi
adjacent	ezotalana
adjective	adjectif
adjust	kobongisa
admire	kosepela
admit	kondima
adopt	kondima
adorable	kitoko
advanced	kokende liboso
advance	kokende liboso
advantage	litomba
adventure	kosakana
adverb	adverbe
advertisement	piblisite
advertising	piblisite
advice	toli
advise	toli
advocate	kokotela
aesthetic	kitoko
affair	likambo
affection	bolingo
affect	kozala na bopusi
affordable	ntalo malamu
afford	kopesa nzela
afraid	kobanga
afternoon	nsima ya nzanga
after	nsima
afterwards	na nsima
again	lisusu
against	kontre
age	mbula
agency	lisanga
agent	mosali
aggressive	mobulu
agile	koningana
agree	kondima
agreement	boyokani
agriculture	mosala ya bilanga
ahead	liboso
aid	lisungi
aim	mokano
air	mopepe
airport	libanda ya mpepo
aisle	nzela
alarm	alarme
alcohol	masanga
alert	koyebisa
a little	mwa moke
alive	kozala na bomoi
all	nyonso
allowed	kopesa
allow	kopesa nzela
all right	malamu
all the best	natombeli makambo ya kitoko
almost	mwa moke
alone	yo moko
along	elongo
a lot	mingi
a lot of	ebele
already	deja
Alright	Malamu
also	lisusu
alternative	mosusu
although	atako
always	ntango nyonso
amazing	kokamwa
ambiguous	eza polele te
ambition	makanisi
ambitious	koluka kozwa bokonzi
amend	kobongola
amid	na kati ya
am	naza
among	na kati
among us	kati na biso
amount	motango
amusing	kosakana
analysis	botaleli
ancestors	bankoko
anchor	prezida
ancient	kala
and	mpe
and you	ebongo yo
angel	anzelu
anger	nkanda
angle	angle
angry	nkanda
animal	nyama
ankle	cheville
an	moko
anniversary	aniversere
announcement	liyebisi
annoyed	kolembisa
annoying	kotungisa
annoy	komitungisa
annual	ya mbula
anonymous	kozanga kotanga nkombo
another	mosusu
answer	eyano
anticipate	kokanisa liboso
anxiety	susi
anxious	mitungisi
anymore	banda sikoyo
any	nyonso
anyone	moto nyonso
anything	eloko nyonso
anyway	eza bongo to te
anyways	ezala bongo to te
apart	longola
apartment	ndako
apologize	kosenga bolimbisi
apparent	komonana neti
apparently	neti
appeal	kosenga batelela lisusu ekateli
appearance	komonana
appeared	ebimaki
appear	komonana
appetite	mposa ya kolya
apple	pomme
application	ndenge ya kosalela
apply	kosalela
appointment	likita
appreciate	kosepela
appreciation	botondi
approach	kopusana
appropriate	ebongi
approval	kondima
approved	kondima
approve	kondima
approximately	pene
april	sanza ya minei
arbitrary	kaka bongo
architect	architekte
architecture	architecture
archive	biloko babomba
area	esika
are	bazali
are you busy	oza na mosala mingi
are you married	obala
are you married or single	obala to oza monzemba
are you	oza
Are you still there?	Oza kaka wana?
are you there	oza kuna
argue	kosolola
argument	likanisi
arise	kobima
arm	loboko
army	mampinga
around	zingazinga
arrange	kobongisa
arrangement	ebongiseli
arrival	boeyi
arrived	kokoma
arrive	kokoma
arrogant	lofundu
arrow	tolotolo
article	artikle
artificial	ya bato basala
artist	artiste
art	mayele
ashamed	nsoni
ash	putulu
asked	atunaki
ask	kotuna
asleep	kolala
as long as	ntango
as	ndenge
aspect	kitoko
Assamese	Assamese
assault	kobundisa
assembly	lisanga
assertive	kondimisa
assess	kotalela
assessment	botaleli
asset	biloko
assets	biloko oza na yango
assign	kopesa mosala
assignment	mosala
assistant	molandi
assist	kosalisa
associated	boyokani
associate	kosangana
association	lisanga
assume	kokanisa
assumption	kokanisa
as well as	mpe
as well	mpe
ate	kolya
athlete	mosani
at least	ata
at	na
attached	kokangama
attach	kokanga
attachment	kokangama
attack	kobundisa
attempt	komeka
attendance	koya
attend	kokende
attention	likebi
attitude	bizaleli
attraction	kobenda likebi
attractive	kitoko
attract	kobenda
attribute	ezaleli
audience	bayoki
august	sanza ya mwambe
aunt	tata-mwasi
aunty	tata-mwasi
authentic	ya solo
authority	mokonzi
author	mokomi
autumn	automne
available	ezali
average	moyenne
avoid	koboya
awake	kolamuka
award	mbano
aware	koyeba
awareness	koyeba
away	mosika
awesome	kitoko makasi
awful	ya mpasi
awkward	mabe
Aymara	Aymara
baby	bebe
bachelor	baccalauréat
background	nsima
back	mukongo
bad	mabe
bag	saki
bait	pambu
bake	kotumba
bakery	esika batumbaka mampa
baking soda	bicarbonade
balance	solde
ball	bile
Bambara	Bambara
banana	etabe
band	etuluku
bang	makelele makasi
bank	banki
barely	moke
bargain	likambo ya malamu
bark	mposo
barley	orge
bar	nzete
barrier	lopango
based	na kotalela
basement	nse
base	nse
basically	mbala mingi
basic	ya ntina
basil	basilique
bastard	mwana-makangu
batch	etuluku
bath	kosokola
bathroom	douche
battery	pile
battle	bitumba
bay	libongo
beach	libongo
beam	likonzi
beans	madesu
beard	mandefu
bearing	etamboli
bear	ours
beast	nyama
beat	kobeta
beautiful	kitoko
beauty	bonzenga
became	kokoma
be careful	keba
because	mpo
become	kokoma
bed	mbeto
bedroom	chambre
beef	ngombe
been	kozala
bee	nzoyi
beer	masanga
before	liboso
began	kobanda
begin	kobanda
beginning	ebandeli
behalf	bolamu
behave	komitambwisa
behavior	ezaleli
behaviour	ezaleli
behind	nsima
being	kozala
be	kozala
belief	kondima
believe	kondima
belly	libumu
belong	kozala ya
beloved	moto balingaka mingi
below	na nse
belt	mokaba
bench	banc
bend	kogumba
beneath	na nse
benefit	litomba
benefits	matomba
beside	pene ya
besides	longola
best	malamu koleka
best of luck	chance malamu
best regards	wa bino
better	malamu koleka
between	na kati ya
beverage	masanga
beyond	koleka
Bhojpuri	Bhojpuri
biased	ya mabe
bias	koponapona
bicycle	velo
bid	kotekisa
big	monene
bike	velo
bill	faktire
bind	kosangisa
bird	ndeke
birthday	aniversere
bite	koswa
bit	eteni
bitter	bololo
black	moindo
blade	mbeli
blame	kopesa foti
blanket	bulangeti
blank	ezangi eloko
blast	kopanzana
bleach	javel
blend	kosangisa
blessed	kopambwama
bless	kopambola
blind	mokufi-miso
bliss	bolamu
block	kokanga
blood	makila
bloom	fololo
blow	kofula mopepe
blue	bleu
blunt	ezangi mino
board	lisanga
boat	masuwa
body	nzoto
boil	kotokisa
bold	molende
bond	boninga
bone	mokuwa
book	mokanda
booster	kolendisa
boost	kobakisa
boot	bote
boots	babote
border	ndelo
bored	kolembisa
bore	libulu
boring	kolembisa
born	kobotama
borrow	kodefa
boss	mokonzi
bother	kotungisa
both	nyonso mibale
bottle	molangi
bottom	nse
bought	kosomba
bounce	kozongela
boundaries	bandelo
bound	kosangisa
bowl	sani
bow	monduki ya tolotolo
box	lopango
boyfriend	likangu ya mobali
boy	mwana-mobali
bracelet	bracelet
brain	boongo
branch	eteni
brand	marke
brave	mpiko
breach	kobuka mobeko
bread	limpa
breakfast	bilei ya ntongo
break	kobuka
breast	mabele
breathe	kopema
breath	kopema
breed	kosangisa
brick	briki
bride	mwasi ya libala
bridge	pont
brief	mokuse
bright	pole
brilliant	kongenga
bring	mema
broadcast	kolakisa
broad	monene
broke	kobuka
broken	ebukani
bro	ndeko
broom	kombo
brother in law	semeki ya mobali
brother	ndeko
brought	komema
brown	marron
brush	brose
bucket	katini
buddy	moninga
budget	mbongo
bug	nyama
building	ndako
build	kotonga
built	kotonga
bulk	mingi
bull	ngombe ya mobali
bully	kotumola
bump	kotambola
bunch	liboke ya fololo
bundle	liboke
burden	bozito
buried	bakundaki
burn	kozikisa
burst	kopanzana
bury	kokunda
bus	bisi
bush	esobe
business	mosala
bust	ntolo
busy	mosala mingi
but	kasi
butterfly	lipekapeka
butter	manteka
button	bouton
buy	kosomba
bye	tikala malamu
by	pene
by the way	kasi
cabbage	choux
cabinet	biro
cage	ndako
cake	gato
calf	mwana ya ngombe
called	abengaki
call	kobenga
call me	benga nga
calm	kimya
came	ayaki
campaign	kampanye
can	akoki
Cancel	Kolongola
cancer	kansere
can't	nakoki te
capable	kokoka
capacity	makoki
capital	mboka-mokonzi
caption	maloba
capture	kokanga
career	mosala
careful	likebi
carefully	malamumalamu
careless	kozanga likebi
caring	likebi
car	motuka
carpenter	mosali mabaya
carpet	tapis
carrot	carrote
carry	komema
carry on	koba kosala
carry out	kosala
case	likambo
cash	mbongo na maboko
cast	kobwaka
castle	ndako monene
casual	bongobongo
catch	kokanga
category	lolenge
cat	niawu
cattle	bangombe
caught	kokanga
cause	ntina
caution	kokeba
cautious	mayele
cave	libulu
cease	kotika
ceiling	plafond
celebrate	kosala feti
cell	selile
center	katikati
century	ekeke
cereal	cereale
ceremony	molulu
certain	lolenge
certainly	ya solo
certificate	diplome
chain	chene
chair	kiti
challenge	komekama
chance	shanse
change	kobongola
chaos	mobulungana
character	ezaleli
characteristics	bizaleli
charge	kofunda
charity	kokabela babola
charming	bonzenga
chart	karte
chase	kolanda
chat	kosolola
cheap	ntalo malamu
cheating	koyiba
cheat	koyiba
check	kotala
cheek	litama
cheerful	esengo
cheer	kokumisa
cheers	kobetela maboko
cheese	fromage
chemistry	chimie
cherish	kolinga
chess	kopola
chest	ntolo
chew	kotafuna
chicken	soso
chief	mokonzi
childhood	bomwana
child	mwana
children	bana
chill	malili
chimneys	banzela
chin	mbebo
chocolate	chocolat
choice	liponi
choose	kopona
chop	kokata
chores	misala ya ndako
chubby	monene
church	ndako ya nzambe
cinnamon	nkoko
circle	libungutulu
circumstances	makambo
citizen	mwana-mboka
city	engumba
claim	koloba
clarify	polele
class	kelasi
clay	argile
clean	peto
clear	polele
clerk	greffier
clever	mayele
client	kiliya
cliff	mabanga
climate	climat
climb	komata
clingy	ekangamaka
clock	montre
close	kokanga
closet	armoire
cloth	elamba
clothes	bilamba
cloud	mapata
cloudy	mapata
clown	moto alati banzambala
clue	eloko ezosalisa na koyeba
clumsy	mabe
cluster	etuluku
coach	entraineur
coal	likala
coast	mopanzi
coat	kazaka
coffee	kafe
cognitive	mayele ya kelasi
coincidence	kosalema kaka bongo
cold	malili
collapse	kokwea
collar	liyaka
colleague	moninga
colleagues	baninga
collection	liboke
collect	kosangisa
college	eteyelo
color	langi
colorless green ideas slept furiously	makanisi ya malamu ezangi langi alalaki na nkanda
colour	langi
column	molongo
combination	kosangisa
combine	kosangisa
comb	kisanola
come here	yaka awa
come on	yaka
come	yaka
comfortable	malamu
comfort	malamu
coming	ezoya
coming soon	ezobima kala mingi te
command	mobeko
comment	komantere
commercial	ya mombongo
commission	mosala
commit	kosala
commitment	komipesa
committed	komipesa
commodity	biloko ya ntina
common	mbala mingi
communicate	kosolola
communication	kosolola
community	esika bofandi
commute	kokende esika mosusu
companion	moninga
company	moninga
compare	kokokanisa
comparison	bokokanisi
compassionate	boboto
compassion	mawa
compatible	kokokana
compete	kobunda
competent	abongi
competition	komekana
competitive	komekana
complain	komilela
complaint	komilela
complement	kobakisa
completely	mobimba
complete	mobimba
complex	ya mindondo
compliance	komesana
complicated	mindondo
compliment	kokumisa
comply	kotosa
composition	biloko ezali na kati
compound	lopango
comprehension	kokanga ntina
comprehensive	ya mobimba
compromise	kobuka mibeko
compulsory	ya makasi
computer	ordinatere
concentrate	kotya makanisi esika moko
concept	likanisi
concerned	komitungisa
concern	komitungisa
concert	concert
conclusion	maloba ya nsuka
concrete	ya solosolo
condition	ezaleli
conditions	makambo
conduct	kotambwisa
conference	likita
confess	kotubela
confidence	kotya motema
confident	kotya motema
confirm	kondimisa
conflict	matata
confused	kobulungana
confusion	mobulungano
congrats	longonya
congratulation	longonya
congratulations	longonya
conjunction	elongo
connect	kosangana
conquer	kolonga
conscious	koyeba
consciousness	kosala mosala malamu
consent	kondima
consequences	bampasi
conservation	kobomba
conservative	kobatela
considered	kotalela
consider	kotalela
consistency	mbala na mbala
consistent	ebongi
consist	etali
constant	ebongwanaka te
constantly	mbala na mbala
constipation	mpota libumu
construction	kotonga
consume	kozikisa
consumption	komela
contact	kokutana
contagious	epanzanaka
contain	kozala na
contains	ezali na
contemporary	bato ya eleko moko
contempt	kotyola
content	makambo eza na kati
contest	lisano ya komekana
context	makambo bazolobela
continent	kontina
continue	kokoba
contract	kontra
contrast	bokeseni
contribute	kopesa
contribution	likabo
control	koyangela
controversial	ebimisi matata
convenience	ndenge olingi
convenient	ebongi
conversation	lisolo
convert	kobongola
convey	kopesa
convinced	kondimisa
convince	kondimisa
cooking	kolamba
cook	kolamba
cool	malili
cooperation	boyokani
cope	kobunda
copper	kwivre
core	mokokoli
corner	coin
corn	masangu
correct	malamu
cost	ntalo
costume	bilamba
cottage	ndako ya zamba
cotton	coton
couch	kiti ya divan
cough	kosukosu
could	akoki
council	bakambi
counter	comptoire
count	kotanga
country	mboka
countryside	mboka
couple	mobali na mwasi
courage	mpiko
course	nzela
court	esambiselo
courtesy	na ndingisa ya
cousin	cousin
cover	ezipeli
coward	zololo
cow	ngombe
cozy	malamu
crab	crabe
crack	kopasuka
craft	misala ya maboko
crap	buzoba
crash	kopanza
craving	mposa
crawl	konguluma
crazy	ligboma
create	kosala
creative	makanisi ya kosala
credit	nyongo
creep	konguluma
creepy	ezobongisa
crew	bato ya ekipe
crime	mbeba
cringe	mabe
crisis	maladi
criteria	masengami
critical	ntina
criticism	kolobela mabe
crop	biloko balongoli na bilanga
crops	biloko ya bilanga
cross	kokatisa
crowd	bato ebele
crowded	etondi na bato
crow	libata
crown	motole
crucial	ntina
cruel	nko
cruise	masuwa ya monene
crush	crochet
cry	kolela
cucumber	concombre
cuddle	lipwepwe
culture	bokoko
cunning	mayele mabe
cupboard	esika ya kobomba biloko
cup	kopo
curb	ndelo
cure	kobikisa
curfew	couvre-feu
curiosity	koluka koyeba
curious	koluka koyeba
curly	elingami
currency	mbongo
currently	sikoyo
current	ya sika
curse	elakeli mabe
curtain	rido
cushion	coussin
customer	kiliya
custom	momeseno
customs	bizaleli
cute	kitoko
cut	kokata
cycle	sikle
cycling	kokumba velo
daddy	papa
dad	papa
daily	mokolo na mokolo
dairy	miliki
damage	kobebisa
dam	kosala lopango
damn	balakeli mabe
damp	malili
dance	kobina
danger	likama
dangerous	likama
dark	molili
darling	sheri
dash	tablo
data	bansango
date	dati
daughter	mwana-mwasi
day	mokolo
deadline	dati ya nsuka
dead	mowei
deaf	moto akufa matoyi
deal	likambo
Dear All	Bandeko
Dear Customer	Ndeko Kiliya
dear	molingami
Dear Parents	Baboti
Dear Sir	Monsieur
Dear students	Bana kelasi
Dear Team	Bandeko Libota
death	liwa
debate	lisolo
debit	nyongo
debris	bosoto
debt	nyongo
decade	bambula zomi
decay	kobeba
deceased	akufa
deceive	kokosa
december	sanza ya zomi na mibale
decent	ebongi
decided	kozwa ekateli
decide	kozwa ekateli
decision	ekateli
deck	kotyola
decline	koboya
decrease	kokita
dedicated	komipesa
dedication	komipesa
deed	mokanda ya koteka eloko
deep	mozindo
deer	mbuli
default	mbeba
defeat	kopolisa
defend	kobunda
define	kolimbola
definitely	bongo mpenza
definition	ndimbola
degree	diplome
delayed	kozelisa
delay	kozelisa
delete	boma
deliberate	na nko
delicate	kotalela na mayele
delicious	elengi
delighted	kosepela
delight	kosepela
delivered	kopesa
deliver	kopesa
delivery	kopesa
demanding	kosenga makambo mingi
demand	kosenga
democracy	demokrasi
demonstrate	kolakisa
demon	zabolo
denied	kopekisa
density	kotonda
dentist	monganga ya mino
deny	kopekisa
department	departema
departure	kokende
depend	kotalela
deploy	kotinda
deposit	kopesa
depressed	konyokwama na makanisi
depression	konyokwama na makanisi
depth	bozindo
describe	kolimbola
description	ndimbola
desert	mabele ekauka
deserve	kobonga
designation	ndimbola
design	likanisi ya kosala eloko
desire	mposa
desk	biro
despair	mawa
desperate	kozala na mposa
despite	atako
dessert	bilei ya sukali
destination	esika
destiny	makambo makanama
destroy	koboma
destruction	koboma
detail	makambo ya mikemike
details	makambo ya mike
detect	komona
determination	ekateli
determined	kozala na mokano
determine	kotalela
devastated	kobebisa
developed	kosala
develop	kosala
development	bokoli
device	apareyi
devil	zabolo
devoted	komipesa
Dhivehi	Dhivehi
diabetes	diabete
diarrhea	pulupulu
diary	aganda
dictionary	diksionere
did	asalaki
died	kokufa
die	kokufa
diet	bilei
difference	bokeseni
different	ekeseni
difficult	mpasi
dig	kotimola
dignity	lokumu
diligent	molende
dinner	bilei ya midi
dip	kozindisa
direction	ngambo
direct	mbala moko
director	diretere
dirt	bosoto
dirty	mbindo
disabled	bakanga
disable	kolongola
disappear	kolimwa
disappointed	alembaki nzoto
disaster	likama
discard	kolongola
discharge	kobimisa
discipline	disipline
discount	kokitisa ntalo
discover	komona
discrimination	kozwela bato makinisi mabe
discussion	lisolo
discuss	kolobela
disease	bokono
diseases	bokono
disguise	kosala neti oza moto mosusu
disgusting	mabe
dish	bilei
dishes	basani
dismiss	kolongola
dispatch	kotinda
display	kolakisa
disposal	kobwaka
dispute	koswana
distance	ntaka
distinct	ya kokesena
distinguish	kokesenisa
distress	mpasi
distribution	kokabola
district	etuka
disturb	kotungisa
ditch	libulu
dive	kozinda na mai
diverse	ndenge na ndenge
diversity	bokeseni
divide	kokabola
divine	ya nzambe
divorce	koboma libala
dizzy	kizunguzungu
doctor	monganga
document	mokanda
does	kosala
dog	mbwa
Dogri	Dogri
doing	kosala
doll	popi
domain	esika
domestic	ya ndako
dominant	ya makasi mingi
donate	kopesa libonza
done	esalemi
donkey	mpunda
don't	kosala te
Don't worry	Komitungisa te
dope	bilangwiseli
do	sala
double	mibale
doubt	ntembe
dough	pate ya mampa
download	kozwa
down	na nse
do you love me	olingaka nga
do you	oza
draft	komeka
drag	kobenda
drain	kopupola
drama	drame
drawer	tiroir
drawing	elilingi
draw	kobenda
dread	bobangi
dream	ndoto
dress	elamba
drill	zamba
drink	komela
drive	kokumba
drop	kokwea
dropped	kosundola
drought	elanga
drunk	kolongwa
dry	kokauka
duck	libata
dude	moninga
due	delai
due to	mpo na
dull	bongobongo
dumb	bolole
dump	kosopa
duration	boumeli
during	na boumeli
dust	putulu
duty	mosala
dwell	kofanda
dying	kokufa
each	mokomoko
each other	moko na mosusu
eager	mposa
eagle	mpongo
earlier	oyo eleki
ear	litoyi
early	ebandeli
earn	kozwa
ears	matoi
earth	mabele
earthquake	koningana ya mabele
ease	pete
easily	na pete
east	este
easy	pete
eating	kolya
eat	kolya
economic	ya nkita
economy	nkita
edge	nsonge
edit	kokoma
education	mateya
effect	bopusi
effective	ezosala malamu
efficiency	ebongi
efficient	ya ntina
effort	molende
egg	liki
eggplant	aubergine
ego	moimi
eighteen	zomi na mwambe
eight	mwambe
eighty	ntuku mwambe
either	to
elaborate	ya mindondomindondo
elbow	moleku
elderly	mobange
elder	nkuluntu
elegant	kitoko
element	eloko
elephant	nzoku
eleven	zomi na moko
eligible	kondimama
eliminate	kolongola
else	mosusu
embarrassed	kopesa nsoni
embarrassing	kopesa nsoni
embrace	koyamba
emerge	kobima
emergency	likambo ya mbalakaka
emotional	ya mayoki
empathy	komitya na esika ya moto
emphasis	kobenda likebi
emphasize	kobeta nsete
employee	moto ya mosala
employees	bato ya mosala
employer	patron
employment	mosala
empty	mpamba
enable	kopesa nzela
encounter	bokutani
encourage	kolendisa
endangered	kozala na likama
endeavor	molende
end	nsuka
endurance	kokanga motema
endure	kokanga motema
enemy	monguna
energy	nguya
engaged	komipesa
engage	komipesa
engagement	komipesa
engineer	enzieniere
engine	moteur
English	Lingelesi
enhance	kokomisa kitoko
enjoy	sepela
enormous	monene
enough	mingi
ensure	kolandela
enter	kokota
entertainment	masano
enthusiasm	esengo
enthusiastic	esengo
entire	mobimba
entitled	eza na moto ya likambo
entity	eloko
entrance	ekoteli
entrepreneur	mokambi
envelope	amvelope
environment	esika
envy	kolula
epic	ya ntina
epidemic	maladi mabe
equal	ndenge moko
equipment	biloko
equity	mbongo
equivalent	ekokani
eraser	koboma
error	libunga
escape	kokima
especially	mingimingi
essay	komeka
essence	ndimbola
essential	ya ntina
established	kosala
establish	kotya
estate	etuka
estimated	kopesa likanisi
estimate	komeka
etc	bongo na bongo
eternal	seko na seko
ethics	bizaleli malamu
evaluate	kotalela
evaluation	kotalela
even	ata
evening	mpokwa
even though	atako
event	likambo
eventually	nsukansuka
ever	ata moke te
everybody	bato nyonso
every	nyonso
everyone	bato nyonso
everything	biloko nyonso
evidence	elembeteli
evil	mabe
evolution	komibimela
evolve	kobongwana
Ewe	Ewe
exact	bongo
exactly	bongo mpenza
exam	ekzame
examine	kotalela
example	ndakisa
exceed	koleka
excellent	kitoko
exception	longola
except	longola
excessive	kolekisa ndelo
excess	oyo eleki likolo
exchange	kobongola
excited	kozala na esengo
excitement	esengo
exciting	ya esengo
exclusive	ye moko
excuse	bolimbisi
excuse me	limbisi nga
execute	kosala
execution	kosala
executive	mokambi
exercise	ngalasisi
exhausted	kolemba
exhaust	kolemba
exhibition	kolakisa biloko
exhibit	kolakisa
existence	kozala na bomoi
existing	ezali
exist	kozala
exit	kobima
ex	ndakisa
expand	kokomisa monene
expected	kozela
expect	kozela
expenses	depanse
expensive	ntalo mingi
experience	ekperianse
experiment	komeka
expert	moto ya mayele
expired	kosila ngala
explain	kolimbola
explanation	ndimbola
exploit	kosalela
explore	kotala
export	kotinda
exposed	kobimisa
expose	kolobela
exposure	kolakisa
expression	maloba
express	koloba
extended	kokomisa monene
extend	kokomisa mingi
extension	kolandana
extent	kolandana
external	ya libanda
extinct	koboma
extract	kobimisa
extra	mosusu
extraordinary	ya kokamwa
extremely	mingi
extreme	makasi
eye	liso
eyes	miso
fabric	elamba
fabulous	ya kitoko
face	elongi
facilitate	kosalisa
facilities	bisika
facility	esika
fact	likambo ya solo
factor	likambo
factory	izine
facts	makambo ya solo
fade	kolimwa
failed	kolonga te
fail	kopola
failure	kopola
faint	kolemba
fair	bosembo
fairly	malamu
fairy	lisolo
faithful	sembo
faith	kondima
fake	lokuta
fall	kokwea
false	lokuta
fame	lokumu
familiar	eyebana
family	libota
famine	nzala
famous	eyebana
fancy	fantaisie
fantastic	malamu mpenza
fan	ventilateur
farewell	mbote ya nsuka
farmer	moto ya bilanga
farm	ferme
far	mosika
fascinating	kokamwa
fashion	mode
fast	noki
fatal	mabe
fate	makambo ekanama
father	papa
fatigue	kolemba
fat	mafuta
fault	libunga
favorite	oyo balingaka mingi
favourite	oyo balingaka
favour	kosalisa
fear	bobangi
feast	kosala feti
feather	masala
feature	eteni
features	biteni
february	sanza ya mibale
fed up	kolemba
feedback	komantere
feed	bilei
feeling	mayoki
feel	koyoka
fee	motanga
feet	makolo
fell	kokwea
fellow	moninga
felt	koyoka
female	ya mwasi
fence	lopango
fertile	ebotaka
festival	feti
fetch	kokende koluka
fever	fievre
fewer	moke
few	moke
fiance	fiancé
fiction	lisapo
field	elanga
fierce	makasi
fifteen	zomi na mitano
fifty	ntuku mitano
fighting	bitumba
fight	kobundisa
figure	motango
figure out	kozwa
file	dosie
filled	kotondisa
fill	kotondisa
film	filme
filthy	bosoto
finally	nsukansuka
finance	mbongo
financial	ya mbongo
find	kozwa
find out	koyeba
fine	malamu
finger	mosapi
finished	kosukisa
finish	kosilisa
fire	moto
firm	makasi
first name	prenom
first	ya liboso
fish	mbisi
fit	ebongi
five	mitano
fixed	kobongisa
fix	kobongisa
flag	drapo
flash	pole
flat	plat
flawless	kozanga libunga
flaw	mbeba
flee	kokima
flesh	mosuni
flew	kopumbwa
flexible	ya pete
flex	ya pete
flight	mpepo
flip	kobalusa
flirt	flirt
flirting	flirté
float	kotepa
flood	mpela
floor	mabele
flour	farine
flower	fololo
flow	koleka
fluently	malamu
fluent	malamu
fluffy	bongobongo
flu	grippe
fluid	mai
fly	kopumbwa
focus	kotya likebi
foggy	londende
fog	londende
fold	kokumba
folks	bato balingaka mingi
following	kolanda
follow	kolanda
follow up	kolanda
food	bilei
foolish	bozoba
fool	zoba
football	ndembo
foot	likolo
forbidden	epekisami
force	bokasi
forecast	oyo tozokanisa kosala
forehead	mbunzu
foreign	mopaya
forest	zamba
forever	mbula na mbula
For example	Na ndakisa
forget	kobosana
forgive	kolimbisa
forgot	kobosana
for instance	na ndakisa
fork	nkanya
formal	ndenge eyebana
former	ya kala
form	formilere
for	mpo na
fortunately	eza mawa
fortune	bozwi
forty	ntuku minei
forty-two	ntuku minei na mibale
forward	kokende liboso
for you	mpo na yo
foster	koyamba
fought	kobunda
foundation	fondation
found	komona
four	minei
fourteen	zomi na minei
fox	mbwa ya esobe
fragile	ya pete
frame	kadre
framework	kadre
fraud	kobuba
freak	elima
freedom	bonsomi
free	ofele
freeze	kokomisa malili
frequency	mbala oyo esalemaka
frequently	mbala na mbala
frequent	mbala na mbala
fresh	ya sika
friday	mwa mitano
fridge	frigo
friendly	ya malamu
friend	moninga
friends	baninga
friendship	boninga
frightened	kobanga
frightening	kobangisa
frog	ligorodo
from	euti na
front	liboso
frozen	kokomisa glase
fruit	mbuma
frustrated	kolemba nzoto
fuel	carburant
Fulfulde	Fulfulde
full	mobimba
function	mosala
fundamental	ntina
funeral	matanga
fun	kosepela
funny	ezosekisa
furious	nkanda
furniture	biloko ya ndako
fur	nsuki
further	lisusu
furthermore	lisusu
future	mikolo ezali koya
gain	kolonga
game	lisano
gap	bokeseni
garage	garage
garbage	mbindo
garden	bilanga
garlic	litungulu
gate	ekuke
gathering	feti
gather	kosangisa
gauge	jauge
gave	apesaki
gear	vitesi
gender	mobali to mwasi
generally	mbala mingi
general	mbala mingi
generate	kobimisa
generation	molongo ya bato
generous	kokaba
genius	mayele
genre	lolenge
gentle	bonkonde
genuine	solo
gesture	elembo
get dressed	kolata
get	kozwa
getting	kozwa
get up	kotelema
get well soon	bika noki
ghosting	mongandji
ghost	mongandji
giant	elombe
gift	likabo
ginger	tangawisi
girlfriend	likango
girl	mwana-mwasi
give	kopesa
given	kopesa
give up	kotika
glad	esengo
glance	kobwaka lisu
glasses	maneti
glass	maneti
glimpse	komona na liboso
global	ya mikili mingi
gloomy	molili
gloves	gants
glow	kongenga
glow up	kongenga
glue	colle
go ahead	kende liboso
goal	mokano
goals	mikano
goat	ntaba
go away	longwa
god bless you	nzambe apambola yo
god	nzambe
goes	kokende
going	kokende
going to	kokende na
go	kende
gold	wolo
gone	kokende
gonna	nako
good afternoon	nsima ya nzanga malamu
goodbye	aurevoir
good bye	tikala malamu
good day	mokolo malamu
good evening	mpokwa malamu
good job	mosala malamu
good looking	boluki malamu
good luck	shanse
good	malamu
good morning	mbote
good morning my love	mbote sheri
good night	butu malamu
goodnight	butu malamu
goods	biloko
Google	Google
Google Translate	Libongoli ya Google
goo	lolango
goose	libata
gorgeous	bonzenga
gossip	nungunungu
got it	nazwi yango
got	kozwa
go to bed	kende kolala
government	boyangeli
grab	kokanga
grade	bapoint
gradually	malembemalembe
graduate	kozwa diplome
grain	mbuma
granted	kopesa
grant	kodnima kopesa
grapes	bambuma ya vino
grasp	kokanga
grass	matiti
grateful	botondi
gratitude	botondi
grave	lilita
gray	gris
great	kitoko makasi
greed	lokoso
greedy	moimi
green	vert
greeting	mbote
greetings	mbote
greet	kopesa mbote
grey	gris
grid	reseau
grief	matanga
grind	kotuta
grip	kokanga
grocery	esika batekaka biloko ya nsolo kitoko
groom	mobali ya libala
gross	ya malamu
ground	mabele
group	etuluku
grow	kokola
growth	bokoli
grumpy	kolya mino
Guarani	Guarani
guarantee	ndanga
guard	kokengela
guess	kokanisa
guest	mopaya
guidance	litambwisi
guide	kokamba
guilty	ngambo
guy	mwana-mobali
guys	bana-mibali
gym	ngalasisi
habitat	esika ya kofanda
habit	ezaleli
had	kozala na
hail	libanga
hair	nsuki
half	katikati
hall	ndako
handle	kosalela
hand	loboko
handsome	kitoko
hang	kokanga
hang out	kobima
happened	esalemaki
happen	kosalema
happiness	esengo
happy birthday	mbotama elamu
happy birthday to you	mbotama elamu
happy	esengo
happy new year	mbula ya sika elamu
hardly	ata moke te
hardly ever	ata moke te
hard	makasi
harmful	ya mabe
harm	konyokola
harmony	boyokani
harsh	nko
harvest	kolongola biloko
has	kozala
hate	koyina
have a good day	mokolo malamu
have a nice day	lekisa mokolo malamu
have breakfast	kolya na ntongo
have fun	sepela
have	kozala na
have you eaten	olyaki
having	kozala
hazard	likama
haze	londende
headache	moto mpasi
head	moto
healing	kobikisa
heal	kobikisa
health	kolongono ya nzoto
healthy	kolongono
heard	koyoka
hear	koyoka
heart	motema
heat	molunge
heaven	lola
heavy	kilo
hectic	makasi
he has	azali
height	molai
heir	moto akozwa libula
he is	azali
heist	koyiba
held	kosalema
hell	lifelo
hello dear	mbote ndeko
hello how are you doing	mbote boni
hello how are you	mbote boni
Hello	Mbote
helmet	ekoti
helpful	ezosalisa
help	lisalisi
hence	yango wana
herd	bampate
here	awa
heritage	libula
her	ye
hesitate	kokakatana
he	ye
Hey	Eh
hidden	ya kobombana
hide	kobombana
hierarchy	bokonzi
highlight	kobeta nsete
high	likolo
hi how are you	mbote boni yo
hike	kotambola
hiking	kotambola
hilarious	ezosekisa makasi
hill	ngomba moke
Hi	Mbote
him	ye
hint	elembo
hip	lipeka
hips	loketo
hire	kozwa na mosala
hiring	kozwa na mosala
history	lisolo
his	ya ye
Hi there	Mbote kuna
hit	kosimba
Hmm	Um
hobby	lisano
hold on	kosimba
hold	simba
hole	libulu
holiday	mokolo ya kopema
hollow	libulu
home	ndako
homework	devware
honest	bosolo
honestly	bosolo
Honey	Sheri
honor	lokumu
hood	capot
hook	ndopo
hope	elikya
hopefully	kotya elikya
hopeless	kozanga elikya
hop	kopumbwa
horizontal	ya kolala
horn	liseke
horrible	ya mpasi makasi
horror	nsomo
horse	mpunda
hospitality	koyamba bapaya
hospital	lopitalo
hostile	nko
host	moto ayambi bapaya
hotel	hotele
hot	molunge
hour	ngonga
hours	bangonga
household	libota
house	ndako
how about you	ebongo yo
how are you	boni
how are you doing	oza malamu
how are you doing today	boni yo lelo
how are you today	boni yo lelo
how do you do	boni yo
however	kasi
how is	ndenge nini
how many	boni
how much	boni
how	ndenge nini
how often	mbala boni
how old are you	oza na mbula boni
how was your day	mokolo eleki ndenge nini
how was your night	butu elekaki ndenge nini
hubby	mobali
hub	kostuba
huge	monene
hug	lipwepwe
human	bato
humble	komikitisa
humidity	malili
humid	malili
hundred	nkama
hungry	nzala
hunt	bokila
hurricane	mopepe makasi
hurry	noki
hurry up	sala noki
hurt	kozoka
husband	mobali
hustle	kokosa
hut	kisasa
hygiene	bopeto
I am fine	naza malamu
I am	nazali
I can	nakoki
I can't	nakoki te
ice cream	creme ya malili
ice	glase
ideal	ebongi
idea	likanisi
identical	ya ndenge moko
identify	komona
identity	nkombo
idiot	zoba
idle	goigoi
I do	Nasalaka
I do not know	Nayebi te
I do not understand	Nakangi ntina te
I don’t know	nayebi te
I don't know	Nayebi te
I don't	nalingi te
I don't understand	Nazokanga ntina te
I don’t understand	Nazokanga ntina te
I don't understand what you mean	Nakangi te ntina ya makambo olobi
I don't understand you	Nazo comprendre yo te
if	soki
ignore	kokipe te
i guess	nakanisi
I had	nazalaki
I have been	Nasi nakenda
I have	nazali na
I hope so	nakanisi bongo
I know	Nayebi
I like	Nalingaka
I like you	Nalingaka yo
illegal	endimami te na mibeko
ill	maladi
illness	maladi
Ilocano	Ilocano
I love my big brother	Nalingaka yaya na nga ya mobali
I love my big sister	Nalingaka yaya na nga ya mwasi
I love my father	Nalingaka papa na nga
I love my little brother	Nalingaka leki na nga ya mobali
I love my little sister	Nalingaka leki na nga ya mwasi
I love my mother	Nalingaka mama na nga
I love	Nalingaka
I love you	Nalingaka yo
I love you so much	nalingaka yo mingi
I love you too	nalingaka yo mpe
image	foto
imagine	kokanisa
I mean	nalingi koloba
I'm fine	naza malamu
I'm good	Naza malamu
I'm here	Nazali
I miss you	mposa na yo
I miss you so much	Mposa na yo makasi
immediate	kozanga kozela
immediately	mbala moko
immense	monene
I'm	naza
I’m	Naza
impact	bopusi
impatient	motema likolo
implement	kobanda kosalela
important	ntina
import	komema
impose	kopusa na makasi
impossible	ekoki kosalema te
impression	kolakisa
impressive	ya kokamwa
impress	kokamwisa
improve	kobongisa
improvement	kobongisa
I'm sorry	Bolimbisi
in addition	lisusu
inappropriate	ebongi te
incentive	kolamusa
incident	likambo
include	ezali na
including	ata mpe
income	salere
inconvenience	likama
increased	ekomaki mingi
increase	komata
incredible	ya kokamwa
indeed	ya solo
independent	bonsomi
India	Inde
indicate	kolakisa
indigenous	ya bana-mboka
individual	moto moko
industry	mosala
inevitable	okoki kokima te
In fact	Ya solo
infant	mwana-moke
infection	maladi
infinity	kozanga ndelo
inflammation	kovimba
inflation	komata ntalo
influence	bopusi
information	nsango
inform	koyebisa
in front of	liboso ya
I	Nga
ingredients	biloko
inheritance	libula
initial	ebandeli
initiative	likanisi
injured	kozoka
injury	mpota
in	na
innocent	moto asali eloko te
innovation	likambo ya sika
in order to	mpona
inquiry	kotuna
insane	bozoba
insect	nyama moke
insecure	kozanga libateli
insert	kobakisa
inside	na kati
insight	bwanya
insist	kotingama
insomnia	kozanga mpongi
inspiration	likanisi
inspire	kopesa makanisi
install	ko installer
instance	ndakisa
instant	ndakisa
instead of	olie
instead	olie
instructions	malako
instrument	esaleli
insult	kofinga
insurance	assurance
intact	kaka ndenge ezali
integrity	bosembo
intellectual	moto ya mayele
intelligence	mayele
intelligent	mayele
intended	kozala na likanisi
intend	kokana
intense	makasi
intention	likanisi
interaction	kosala makambo na basusu
interact	kosala makambo
interested	kotya likebi
interesting	kobenda likebi
interest	likebi
interfere	komikotisa
intermediate	ya katikati
internal	ya kati
international	ya mokili mobimba
internship	stage
interpreter	mobongoli
interpret	kobongola
interrupt	kokata
interview	mituna-lisolo
intimate	boninga
into	na kati
introduce	kolobela
introduction	maloba ya ebandeli
introvert	moto abombaka makanisi na ye
intuition	makanisi
invalid	ya mabe
invent	kokela
inventory	emvantere
investigate	kolandela
invest	kotya mosolo
invitation	libyangi
invite	kobengisa
invoice	faktire
involved	komipesa
involve	komipesa
iron	libende
is	azali
I see	namoni
island	esanga
isolated	kozala yo moko
issue	likambo
issues	mikakatano
item	eloko
items	biloko
I think	nakanisi
it is	ezali
it's	eza
its	eza
It's okay	Eza malamu
it's ok	eza malamu
it was	nazalaki
it	yango
I understand	nakangi ntina
I want	nalingi
I want to see you	Nalingi komona yo
I want you	Nalingi yo
I was	nazalaki
I will	Nako
I would be	Nakolinga kozala
jacket	kazaka
jail	boloko
January	Sanza ya Yambo
jar	molangi
jaw	mbanga
jealous	zuwa
jerk	buzoba
jewelry	liyaka
job	mosala
jogging	kosakana
join	kosangana
joint	elongo
joke	liseki
journalist	mopanzi-nsango
journey	mobembo
joy	esengo
judge	kosambisa
juice	jus
july	sanza ya nsambo
jump	kopumbwa
june	sanza ya motoba
junk	mabe
just do it	sala yango kaka
justice	bosembo
justify	komilongisa
just	kaka
Kalaallisut	Kalaallisut
keen	kolinga
keep it up	koba kosala bongo
keep	kobatela
kept	kobomba
kettle	nzungu
key	fungola
kick	kobeta
kidding	kosakana
kid	mwana
kidney	rein
kids	bana
kill	koboma
kinda	bongobongo
kindly	ya boboto
kind	malamu
kindness	motema malamu
king	mokonzi
kiss	bizu
kitchen	kikuku
kite	cerf-volant
kitten	mwana ya niawu
knee	libolongo
knew	koyeba
knife	mbeli
knight	mosali ya mokonzi
know	koyeba
knowledge	boyebi
known	koyebana
Konkani	Konkani
Krio	Krio
label	etikete
labor	mosala
labour	mosala
lack	kozanga
ladder	emateli
lady	elenge mwasi
laid	kotya
lake	laki
lamb	mwana-mpate
lame	ebosono
lamp	mwinda
land	mabele
landscape	paysage
language	lokota
lap	toure ya nzela
large	monene
last but not least	ya nsuka kasi ya moke te
last name	nkombo ya libota
last	nsuka
lately	kala mingi te
late	retard
later	nsima
latest	ya sika mpenza
latter	oyo ya nsuka
laughing	koseka
laugh	koseka
laughter	koseka
launch	kobanda
laundry	esika ya kosokola bilamba
law	mobeko
lawn	pelouse
lawyer	avoka
layer	couche
lay	kotya
layout	kobongisa
lazy	goigoi
leader	mokambi
lead	plomb
leaf	nkasa
leak	kobimisa
lean	moke
leap	kopumbwa
learning	koyekola
learn	koyekola
lease	kofutela
least	moke
leather	kwire
leave	kolongwa
leaves	nkasa
led	kokamba
left	loboko ya mwasi
legacy	biloko bitikela
legal	ya mibeko
legend	legende
legit	ebongi
leg	lokolo
leisure	lisano
lend	kodefisa
length	bolai
less	moke
lesson	liteya
let	kotika
letter	mokanda
lettuce	salade
level	nivo
leverage	levier
liability	mokumba
library	biblioteke
lick	kolembola
lie	kokosa
lies	lokuta
life	bomoi
lift	kotombola
lightning	nkake
light	pole
like	kolinga
likely	neti
likewise	ndenge moko
line	nzela
Lingala	Lingala
link	lien
lion	nkosi
liquid	mai
listening	koyoka
listen	koyoka
list	liste
literally	ndenge ezali
literature	mokanda
litter	moke
little	moke
live	kofanda
liver	foie
lives	bomoi
living	kozala na bomoi
living room	salon
lizard	moselekete
load	kokotisa biloko
loaf	limpa
loan	kodefa
local	ya bana-mboka
location	esika
lockdown	kokanga
lock	serire ya porte
log	zulunalu
lol	lol
lonely	komifandela
long	molai
long time no see	tomonana kala
look	kotala
loop	boucle
loose	ya kofungwama
lord	nkolo
lose	kopola
loss	kobungisa
lost	kobungisa
lot	mingi
loud	makasi
lounge	salon
love	bolingo
lovely	kitoko
love you	nalingaka yo
lower	kokitisa
low	nse
loyal	bosembo
loyalty	boyengebene
luck	chance
lucky	chance
Luganda	Luganda
luggage	bifunda
lump	likala
lunch	bilei ya midi
lungs	bapoumon
luxury	bozwi
lying	kokosa
machine	mashine
madam	madame
made	kosala
mad	liboma
magazine	zulunalo
magnificent	ya kitoko
maid	boyi ya mwasi
maintain	kobatela
maintenance	kobongisa
main	ya monene
Maithili	Maithili
majority	mingi
major	monene
make	kosala
make up	monzele
male	mobali
mall	esika ya mombongo
manage	kosala
management	kokamba
manager	mokonzi
mandatory	esengami
manifest	komonana
manipulate	kosalela
man	moto
manner	lolenge
manual	mokanda
many	ebele
many many happy returns of the day	mikolo mingi lisusu ya malamu
march	kotambola
margin	marge
market	zando
marriage	libala
married	kobala
mask	masque
massive	mingi
mass	mingi
master	nkolo
match	kokokana
mate	molongani
material	eloko
math	matematike
matter	likambo
maturity	bokoli
maybe	mbala mosusu
may	mbala mosusu
meal	bilei
mean	elakisi
meaning	ndimbola
means	elimboli
meant	elimbolaki
meanwhile	na ntango tozozela
measure	emekeli
measures	bimekeli
meat	mosuni
medical	kimonganga
medicine	nkisi ya monganga
meditation	komanyola
medium	katikati
meeting	likita
meet	kokutana
Meiteilon	Meiteilon
melt	kokomisa mai
memories	makanisi
memory	boongo
me	nga
mental	ya moto
mentioned	kolobela
mention	kolobela
mentor	molakisi
merchant	moteki
mercy	mawa
merely	kaka
merry christmas	noël malamu
message	nsango
mess	kobeba
messy	bongobongo
metal	libende
method	metode
me too	nga mpe
mice	mpuku
middle	katikati
midnight	midi ya butu
might	ekoki
mild	boboto
milestone	likambo ya monene
military	soda
milk	miliki
million	milio
mind	makanisi
mindset	makanisi
mine	ya nga
mingle	kosangana
minor	moke
minute	miniti
minutes	miniti
miracle	likamwisi
mirror	talatala
miscellaneous	mosusu
mischievous	mayele mabe
miserable	mawa
misery	mawa
missing	kozanga
mission	mosala
miss	kozanga
miss you	mposa na yo
mistake	libunga
mist	londende
Mizo	Mizo
mobile	ya maboko
mock	kozomela
model	modele
moderate	malembe
modern	ya mikolo oyo
modest	koyeba bandelo
moist	malili
moisture	malili
mold	kobongisa
mole	moto abimisaka basekele
moment	ntango
mom	mama
monday	mwa yambo
money	mbongo
monitor	kolandela
monkey	likaku
month	sanza
mood	humeur
moody	bongobongo
moon	sanza
moral	bizaleli malamu
more	lisusu
moreover	lisusu
morning	ntongo
mortgage	kosimbisa eloko mpo na kodefa
mostly	mbala mingi
most	mingi
mother	mama
motion	koningana
motivation	elendiseli
mountain	ngomba
mouse	mpuku
mouth	monoko
move	koningana
movement	muvema
movie	filme
mrs	madame
much	mingi
mud	potopoto
mug	kopo
muscle	mosisa
museum	esika babombaka biloko ya kala
mushroom	mayebo
music	miziki
must	esengeli
mute	kokanga
mutual	boyokani
My dear	Molingami
my friend	moninga na nga
My hovercraft is full of eels	Motuka na nga etondi na banzombo
my love	bolingo na nga
my name is	nkombo na nga
my pleasure	nasepeli
myself	nga moko
mysterious	ya kokamwa
mystery	sekele
myth	lisolo ya lokuta
my	ya nga
nail	linzaka
naive	yuma
name	nkombo
narrative	kobeta lisolo
narrow	kaka
nasty	mabe
nationality	ekolo
national	mboka
native	mwana-mboka
natural	ya malamu
nature	bozalisi
nausea	mposa ya kosanza
nearby	pene
nearly	pene
near	pene
neat	peto
necessary	ntina
neck	kingo
necklace	nsinga ya monzele
need	mposa
negative	mabe
neglect	komona mpamba
negotiate	kokakola
neighborhood	kartie
neighbor	voisin
neither	moko te
nephew	neveu
nerd	zoba
nervous	nkandankanda
nest	zala
net	monyama
network	reseaux
neutral	koboya kokota
never	ata moke te
never give up	kotika te ata moke
never mind	likambo te
nevermind	likambo te
nevertheless	atako bongo
news	bansango
new	ya sika
next	oyo elandi
next to	pene ya
nice	kitoko
nice to meet you	esengo na kokutana na yo
niece	niece
night	butu
nightmare	ndoto ya mabe
nine	libwa
nineteen	zomi na libwa
ninety	ntuku libwa
nobody	moto moko te
noise	makelele
noisy	makelele mingi
none	moko te
noon	midi
nope	te
no problem	likambo te
normal	ya malamu
north	norde
nor	to
nose	zolo
nostalgic	kokanisa makambo ya kala
not at all	ata moke te
not bad	mabe te
No	Te
noted	kokoma
note	likebisi
nothing	eloko moko te
noticed	komona
notice	komona
Not now	Sikoyo te
not	te
not yet	nanu te
noun	nkombo
nouns	bankombo
novel	ya sika
november	sanza ya zomi na moko
nowadays	lelo
no way	ata moke te
now	sikoyo
nuisance	kopesa mpasi
null	ntina te
numb	ekufa
number	nimero
nurse	infirmier
nut	koko
nutmeg	mbila ya muscade
nutrition	koleisa
oath	ndayi
obesity	monene koleka
obey	kotosa
objective	mokano
object	moto ya likambo
obligation	etinda
obscure	molili
observation	likanisi
observe	kotala
obsessed	kolinga mingi
obsession	komitungisa mingi
obsolete	esila ngala
obstacle	eloko ezokanga nzela
obtained	kozwa
obtain	kozwa
obviously	polele
obvious	polele
occasionally	mbala mingi te
occupation	mosala
occupied	kozala na mosala
occur	kosalema
occurred	kosalema
occurs	esalemaka
ocean	mbu
october	sanza ya zomi
odd	kokamwa
odds	chance
of course	ya solo
offensive	ya nsoni
offer	kopesa
office	biro
official	eyebana
off	likolo ya
often	mbala mingi
of	ya
Oh	O
oh really	oh bongo
oil	mafuta
okay baby	malamu bebe
okay dear	malamu ndeko
okay honey	malamu sheri
okay	malamu
okay my love	malamu sheri
ok dear	malamu moninga
ok honey	malamu sheri
ok my love	malamu shere na nga
ok	ok
old	mokolo
once	mbala moko
one language is never enough	lokota moko ekoki ata moke te
one	moko
onion	litungulu
online	na internet
only	kaka
on	na
open	kofungola
operation	mosala
opinion	likanisi
opportunities	mabaku
opportunity	libaku
opposite	kotelemela
optimistic	makanisi malamu
optional	soki olingi
option	liponi
orange	lilala
order	etinda
ordinary	ya bongobongo
organization	lisanga
orientation	kolakisa ndenge ya kosala
original	esika euti
origin	ebandeli
Oromo	Oromo
orphan	mwana-etike
or	to
other	mosusu
otherwise	soki te
ought	esengeli
Our mission: to enable everyone, everywhere to understand the world and express themselves across languages.	Mosala na biso: kosalisa moto nyonso, esika nyonso na koyeba mokili mpe kobimisa makanisi na bango na balokota.
Our mission: to organize the world's information and make it universally accessible and useful.	Mosala na biso: kobongisa bansango ya mokili mobimba mpe kopesa bato nyonso likoki ya kozwa yango mpe kosalela yango.
our	ya biso
outcome	resultat
outfit	elamba
outgoing	kobima
outlet	kobima
out	libanda
outline	plan
outside	libanda
outstanding	ya kokamwa
oven	foure
overall	mobimba
overcome	kolonga
over	koleka
over there	kuna
overthinking	kolekisa ndelo na kokanisa
overwhelmed	kolekela
overwhelming	kolekela
owe	esengeli
owl	hibou
owner	nkolo
own	ya yo moko
ox	ngombe
pace	vitesi
package	liboke
pack	liboke
paid	kofuta
pain	mpasi
painting	kotya langi
paint	kotya langi
pair	mibale
pale	konzuluka
palm	nzete ya mbila
pandemic	pandemi
panic	kolenga
pan	kikalungu
pants	pantalon
paper	papie
paradise	paladiso
parallel	ezotalana
parcel	lopango
pardon	bolimbisi
parents	baboti
park	parke
parrot	tshaku
parsley	nzete ebengami perse
part	eteni
participate	kosangana
particularly	mingimingi
particular	moko boye
partner	moninga
party	feti
passage	verse
passed	kopesa
passionate	ya bolingo
passion	mposa makasi
passive	kosala eloko te
pass	koleka
password	mot de passe
past	eleka
patch	eteni ya elamba
pathetic	ya mawa
path	nzela
patience	motema molai
patient	moto ya maladi
pattern	ezaleli
pause	kopema
pavement	pavema
pay	kofuta
payment	lifuti
peaceful	kimya
peace	kimya
peach	koloba
peak	nsonge
pear	nsafu
peas	madesu ya petit pois
peculiar	ya ntina
peel	kolongola masala
pee	masuba
peer	moninga
peers	baninga
pen	biki
pencil	crayon
pending	kozelisa
people	bato
pepper	pilipili
perceive	komona
perception	ndenge ya komonela
perfect	ya kokoka
performance	mosala
perform	kosala
perhaps	mbala mosusu
period	eleko
permanent	ya libela
permission	ndingisa
permit	ndingisa
perseverance	kolendendela
persistent	kotingama
personality	bomoto
personal	ya yo moko
person	moto
perspective	likanisi
persuade	kondimisa
pervert	ya mabe
pet	nyama ya kobokola
phase	etape
phenomenon	likambo
philosophy	filozofi
phone	tyombo
photo	foto
phrase	maloba
physical	ya nzoto
pick	kopona
pick up	kozwa
picture	foto
piece	eteni
pieces	biteni
pigeon	ebenga
pig	ngulu
pile	liboke
pillow	eloko ya kotyela moto
pilot	pilote
pineapple	ananas
pin	epingle
pink	rose
pitch	esika
pit	libulu
pity	mawa
place	esika
places	bisika
plague	maladi
plain	pete
plane	mpepo
plan	plan
plant	nzete
plants	banzete
plate	sani
platform	esika
playing	kobeta
play	kobeta
pleasant	kitoko
pleased	kosepela
please	palado
pleasure	esengo
pledge	ndanga
plenty	ebele
plot	lopango
plug	kokotisa
plumber	plombier
plum	nzete babengi prune
plural	boike
podcast	video ya mokuse
poem	poeme
poetry	poeme
point	litono
poison	poison
police	polisi
policy	malako
polite	botosi
pollution	kobebisa mopepe
pond	liziba
pool	liziba
poop	mbindo
poor	mobola
pop	pop
popular	eyebana
population	bato
pork	ngulu
porridge	potopoto
port	ekuke
position	esika
positive	ya malamu
possession	biloko
possessive	kozala na
possess	kozala na
possible	likoki ezali
post	kotya
postpone	kozelisa
potato	mbala
potential	oyo okoki kosala
pound	livre
poverty	bobola
powerful	ya nguya
power	nguya
practical	ya malamu
practice	komeka
praise	kokumisa
prank	liseki
pray	kobondela
precious	kitoko
precisely	bongo mpenza
precise	sikisiki
predict	koloba liboso makambo oyo ekosalema
preference	oyo olingi
prefer	kosepela
pregnant	zemi
prejudice	kosala mabe
premises	bisika
premium	prime
preparation	kobongisa
prepared	kobongisa
prepare	kobongisa
preposition	preposition
presence	kozala
presentation	kolakisa
present	sikoyo
preserve	kobomba
president	prezida
press	bapanzi-nsango
pressure	bopusi
pretend	kosala neti
pretty	mwa kitoko
prevent	kopekisa
previous	oyo eleki
prey	eloko balingi bakanga
price	ntalo
pride	lolendo
priest	nganga-nzambe
primary	ya liboso
prime	ya yambo
princess	mwana-mokonzi
principal	ya yambo
priority	ya ntina mingi
prior	liboso
prison	boloko
privacy	nkuku
private	ya sekele
privilege	libaku malamu
prize	mbano
probably	mbala mosusu
problem	likambo
procedure	ndenge ya kosala makambo
proceed	kosala
process	kosala
produce	kosala
product	eloko
production	kosala
professional	ayebi mosala
profession	mosala
profile	profil
profit	litomba
profound	mozindo
progress	kokende liboso
project	mosala
prominent	ya lokumu
promise	elaka
promote	kopesa maboko
promotion	komatisa grade
prompt	kosenga
prone	kozala pene ya
pronouns	pronoms
pronunciation	elobeli
proof	elembeteli
properly	malamu
proper	malamu
properties	bizaleli
property	lopango
proposal	likanisi
prospect	ndenge ya komonela
prosperity	bozwi
prosperous	bozwi
protect	kobatela
proud	lolendo
prove	kondimisa
provided	kopesa
provide	kopesa
province	provense
provision	ebongiseli
puberty	puberté
public	ya bato nyonso
pull	kobenda
pumpkin	citrouille
punctual	kotosa ngonga
pupil	mwana ya kelasi
purchase	kosomba
pure	peto
purple	pourpre
purpose	mokano
purse	potomone
pursue	kolanda
pursuit	kolandela
push	kotindika
put	kotya
qualification	kokokisa masengami
quality	ndenge ezali
quantity	mingi
quarantine	komifandela
quarrel	koswana
quarter	trimestre
Quechua	Quechua
queen	mokonzi-mwasi
queer	ya kokamwa
query	motuna
question	motuna
queue	molongo ya kozela
quickly	nokinoki
quick	noki
quiet	kimya
quilt	molikani
quite	mwa mingi
quit	kolongwa
quiz	mituna
quotation	kozongela
quote	kozongela
quotes	kozongela maloba
rabbit	lapin
race	mposo ya nzoto
rage	nkanda
rain	mbula
raised	kotombola
raise	kotombola
ran	apotaki mbango
random	kaka ndenge wana
range	mingi
rapidly	nokinoki
rapid	noki
rare	emonanaka mingi te
rarely	mbala mingi te
rash	mbuma
rate	ntalo
rather	olie
rational	esimbami na makambo ya solo
ratio	rapore
rat	mpuku
raw	basaleli nanu te
reached	ekomaki
reach	kokoma
reaction	eyano
reading	kotanga
read	kotanga
ready	ya kobongama
reality	likambo ya solo
realized	koyeba
realize	koyeba
really	mpenza
real	ya solo
rear	nsima
reasonable	makambo makasi te
reason	ntina
recall	kokanisa
receipt	reçu
received	kozwa
receive	kozwa
recently	kala mingi te
recent	ya sika
reception	koyamba
recipe	ndenge ya kolamba
reckless	kozanga kobanga
recognition	kondima
recognize	koyeba
recommended	kolendisa
recommend	kopesa likanisi
record	dosie
recover	kobika
recovery	kobika
rectangle	rectangle
redeem	kosomba lisusu
redemption	kosomba lisusu
red	motane
reduce	kokitisa
redundant	ezozongela
reference	referansi
refer	kolobela
reflection	makanisi
reflect	komonisa
refrain	koboya
refrigerator	frigo
refund	kozongisa mbongo
refused	aboyaki
refuse	koboya
regarding	na oyo etali
regard	kotala
regardless	atako
regards	mbote
region	etuka
register	kokomisa nkombo
regret	mawa
regularly	mbala na mbala
regular	ya mbala na mbala
reject	koboya
related	etali
relate	kobeta lisolo
relationship	boyokani
relative	etali
relatives	bandeko
relax	kopema
released	kobimisa
release	kobimisa
relevant	ya ntina
reliable	ya kotyela motema
relief	lisungi
relieved	kozwa lisungi
relieve	kosalisa
religion	lingomba
religious	ya losambo
re	likambo
reluctant	kokakatana
rely	kotya motema
remaining	bitika
remain	kotikala
remarkable	ya kokamwa
remedy	nkisi
remember	kokundwela
reminder	ekundweli
remind	kokundwela
remote	mosika
remove	kolongola
render	kosala
rent	kofutela
repair	kobongisa
repeat	kozongela
replace	kozwa esika
reply	kopesa eyano
report	rapore
represent	kozala momonisi
reputation	lokumu
request	bosengi
required	esengami
require	kosenga
rescue	kobikisa
research	bolukiluki
resemble	ekokani
resentment	kobomba nkanda
reservation	kokanga esika
reserve	kobomba
resident	moto afandaka
resign	kolongwa mosala
resilience	kokanga motema
resilient	kokanga motema
resistance	kotelemela
resist	kotelemela
resolution	ekateli
resolve	kobongisa
resort	mobenda
resources	biloko
respect	botosi
respond	kopesa eyano
response	eyano
responsibility	mokumba
responsible	mokambi
restaurant	malewa
rest in peace	pema na kimya
rest	kopema
restore	kozongisa
restrict	kopekisa
result	mbano
results	ba resultat
resume	kozongela
retail	koteka ndambondambo
retain	kobatela
retention	kobomba
retired	kotika mosala
retreat	kokima
retrieve	kozwa lisusu
return	kozonga
revealed	komonisa
reveal	koloba
revenge	kozongisa mabe
revenue	mbongo
reverse	kobalusa
review	kotalela
revise	kotalela lisusu
revision	kotalela lisusu
revolution	kobongola makambo
reward	mbano
rhythm	ritme
rib	mopanzi
rice	loso
rich	mozwi
ride	kotambola
ridiculous	ya bozoba
rid	kolongola
right	malamu
right now	kaka sikoyo
rigid	makasi
ring	lopete
rinse	kopangusa
riot	mobulu
ripe	kotela
rip	kopasola
rise	komata
risk	likama
rival	mbanda
river	ebale
road	nzela
roast	kotumba
robust	monene
rock	libanga
rod	nzete
role	mokumba
roll	rulo
roof	toiture
room	chambre
root	mosisa
rope	nsinga
rotten	batumba
roughly	makasi
rough	makasi
round	libungutulu
route	nzela
routine	momeseno
row	molongo
rubber	caoutchouc
rubbish	mbindo
rub	kopangusa
rude	buzoba
rug	tapis
ruin	kobebisa
rule	mobeko
ruler	mokonzi
rules	mibeko
run	kopota mbango
running	kopota mbango
rural	ya mboka
rush	kowela
sack	saki
sacred	santu
sacrifice	mbeka
safe flight	mobembo malamu
safe	libateli
safety	libateli
sage	moto ya bwanya
said	alobaki
sailing	kotambola na masuwa
sail	voile
sake	bolamu
salary	lifuti
sale	koteka
salmon	saumon
salt	mungwa
Same here	Ndenge moko awa
same	ndenge moko
sample	ndakisa
sand	zelo
Sanskrit	Sanskrit
sarcastic	kofinga
sassy	kozanga botosi
satisfaction	kosepela
satisfied	kosepela
satisfying	kosepela
satisfy	kosepela
sat	kofanda
Saturday	Mwa Mposo
sausage	saucisse
savage	ya zamba
save	kobikisa
saw	amonaki
say	koloba
scale	emekeli kilo
scam	kobuba
scarce	mingi te
scared	kobanga
scarf	echarpe
scar	kobanga
scary	kobangisa
scattered	kopanza
scene	esika
scenery	esobe kitoko
scent	nsolo malamu
schedule	manaka
school	eteyelo
science	siansi
scientist	moto ya siansi
scientists	bato ya siansi
scissors	ciseaux
scold	kogangela
scope	ndenge ya kosalela
score	point
scrap	kosundola
scratch	nzela
scream	koganga
screen	ecran
screw	visi
script	maloba
seal	kashe
sea	mbu
search	koluka
season	eleko
seat	kiti
second	ya mibale
secret	sekele
section	eteni
secure	libateli
security	libateli
seed	mbuma
seek	koluka
see	kotala
seem	komonana neti
seems	komonana neti
seen	komona
see you later	tomonani
see you soon	tokomoana kala mingi te
see you	tokomonana
see you tomorrow	tomonani lobi
seize	kokanga
seizure	monene
seldom	mingi te
select	kopona
self healing	komibikisa
selfish	moimi
self	yo moko
sell	koteka
send	kotinda
send me your picture	tindila nga foto na yo
senior	mokolo
sense	mayoki
sensible	makasi te
sensitive	ya ntina
sentence	phrase
sentences	bitumbu
sent	kotinda
separate	kokabola
Sepedi	Sepedi
september	sanza ya libwa
sequence	ndenge esalemaka
series	milongo
seriously	ya mpasi
serious	ya ntina
serve	kosalela
service	mosala
session	eteni
set	kotya
setting	parametre
settle	kobongisa
set up	kobongisa
seven	nsambo
seventeen	zomi na nsambo
seventy	ntuku nsambo
several	ebele
severe	makasi
sew	kotonga
shade	elili
shadow	elili
shake	koningisa
shall	akozala
shallow	likololikolo
shame	nsoni
shape	forme
share	kokabola
sharp	mino
shed	kisasa
sheep	meme
sheet	lokasa
she has	azali
she is	aza
shelf	etagere
shell	mposo ya liki
shelter	esika ya kobombana
she	ye
shield	nguba
shift	ekipe
shine	kongenga
ship	masuwa
shipping	kotinda
shirt	chemise
shoes	basapatu
shoot	kobeta
shop	butike
shopping	kosomba
shore	libongo
shortage	kozanga biloko
short	mokuse
shot	kobeta
shoulder	lipeka
should	esengeli
shout	kokanga
shower	kosokola
show	kolakisa
show me	lakisa nga
shrimp	mbinzo
shrink	kozinda
shut	kokanga
shut up	kanga
shy	nsoninsoni
sibling	ndeko
siblings	bandeko
sick	maladi
side	mopanzi
sigh	kolela
sight	komona
sightseeing	kokende kotala
signature	siniatire
sign	elembo
significant	ntina
silence	nye
silent	nye
silk	soie
silly	zoba
silver	palata
similar	ndenge moko
simple	pete
simultaneously	nzela moko
since	banda
sincere	bosolo
sincerely	wa yo
singer	moyembi
sing	koyemba
single	moko
sink	kodinda
Sir	Monsieur
sister in law	semeki ya mwasi
sister	ndeko-mwasi
site	esika
sit	kofanda
situation	likambo
six	motoba
sixteen	zomi na motoba
sixty	ntuku motoba
size	bonene
skill	mayele
skills	mayele
skin	mposo
skinny	mike
skip	kokipe te
skirt	jupe
sky	mapata
slave	moombo
sleeping	kolala
sleep	mpongi
sleepy	mpongi
sleeve	loboko ya elamba
slice	eteni
slide	diapositive
slightly	moke
slim	moke
slip	kosieta
slope	pente
slot	fente
slowly	malembe
slow	malembe
small	moke
smart	mayele
smell	nsolo
smile	komunga
smoke	komela makaya
smooth	pete
snack	bilei
snail	mbembe
snake	nyoka
snap	koswa noki
snow	mbula mpembe
soak	kozindisa
soap	savon
sober	malamu
soccer	mobeti-ndembo
social	makambo ya bomoi
society	lisanga
socks	chaussettes
so cute	kitoko makasi
so far	kino sikoyo
soft	pete
software	logiciel
soil	mabele
soldier	soda
sold out	kolemba
sold	solde
sole	yango moko
solid	makasi
solution	solution
solve	kobongisa
somebody	moto moko
somehow	ndenge moko boye
some	mosusu
someone	moto moko
something	eloko moko
sometimes	bantango mosusu
song	loyembo
soon	kala mingi te
sophisticated	ya mindondo
Sorani	Sorani
sore	mpasi
sore throat	mongongo mpasi
sorrow	mawa
Sorry	Bolimbisi
sort	kotya na molongo
sought	koluka
soulmate	molongani
soul	molimo
sound	makelele
soup	supu
source	esika
sour	ngayi
south	sude
so	yango wana
space	esika
spam	mikanda ya mabe
span	bonene
Spanish	Espagnole
spare	kobikisa
speak	koloba
special	ntina
species	biloko
specific	ya sikisiki
spectacular	ya kokamwa
speechless	kozanga koloba
speech	maloba
speed	vitesi
spell	koloka
spend	alekisaki
spent	kosalela
spicy	ezosua
spike	nsonge
spinach	epinard
spin	kobalusa
spirit	elimo
spit	kobwakela soi
splendid	kitoko
split	kokabola
spoiled	kobebisa
spoil	kobebisa
spontaneous	na mbala moko
spoon	lutu
spot	litono
spouse	molongani
spread	kopanza
spring	printemps
square	carré
squeeze	kopusa
squid	calmar
squirrel	ecureuil
stab	kotyuba
stable	ebongi
stack	liboke
staff	bato ya mosala
stage	ebayelo
stain	litono
stairs	bimateli
stake	nzete
stalk	nzete
stall	kolongwa
stamp	kashe
standard	ya malamu
stand	eloko
star	monzoto
started	alobaki
start	kobanda
starving	nzala makasi
state	etuka
statement	maloba
station	esika engbunduka etelamaka
statue	ekeko
status	statut
stay	kotikala
stay safe	zala mayele
steady	mbala na mbala
steak	eteni ya mosuni
steal	koyiba
steam	mopepe
steel	acier
steep	mpwasa
stem	kobima
step	etambe
stick	nzete
stiff	eloko
still	kaka
sting	koswa
stingy	moimi
stir	koningisa
stock	likambo
stolen	bayiba
stomach	estoma
stone	libanga
stood	kotelema
stool	tabouret
stop	kosukisa
storage	esika ya kobomba biloko
store	butiki
storm	mopepe makasi
story	lisolo
stove	mbabola
straightforward	mbala moko
straight	mbala moko
strain	likambo ya mpasi
stranger	mopaya
strange	ya kokamwa
strategy	mayele
strawberry	fraise
straw	esobe
streak	nsinga
stream	mai moke
street	balabala
strength	makasi
stress	kobeta sete
stretch	komitandola
strict	makasi
strike	kobeta
string	shene
strip	kotika bolumbu
strive	kosala makasi
stroke	avc
strong	makasi
struck	kobeta
structure	ndenge ezali
struggle	kobunda
struggling	kobunda
stubborn	moto makasi
stuck	kokangama
student	mwana-kelasi
studying	koyekola
study	koyekola
stuff	makanisi
stunning	kitoko makasi
stupid	bolole
style	lolenge
subject	moto ya likambo
submission	botosi
submit	kotinda
substance	ntina
substitute	moto akozwa esika
subtle	ya nsense
succeed	kolonga
successful	kolonga
success	kolonga
such as	na ndakisa
such	neti
suck	kolembola
suddenly	na mbala moko
sudden	na mbalakaka
suffering	bampasi
suffer	konyokwama
sufficient	ebongi
sugar	sukali
suggestion	likanisi
suggest	kopesa likanisi
suitable	ebongi
suitcase	valise
suit	kazaka
summary	na mokuse
summer	eleko ya molunge
summit	nsonge
sum	motango
sunday	mwa lomingo
sun	moi
sunny	moi makasi
sunset	kozinda ya moi
sunshine	kongenga ya moi
superior	aleki
super	kitoko
supervisor	mokengeli
supper	bilei ya mpokwa
supply	kopesa
support	lisungi
supposed	oyo bakanisaki
suppose	kokanisa
sure	solo
surface	etando
surge	kobima na mpwasa
surgery	lipaso
surname	nkombo ya libota
surprised	kokamwa
surprise	kokamwisa
surrender	komipesa
surrounding	zingazinga
surveillance	kokengela
survey	sondage
survive	kobika
suspect	moto bazokanisa
suspended	kolongola
suspicious	kozala na makanisi ya mabe
sustainability	eumelaka
sustainable	eumelaka
sustain	kopesa maboko
swag	saki ya mokongo
swallow	komela
swap	kosala echange
swear	kolapa ndai
sweater	elamba ya molunge
sweat	motoki
sweep	kokomba
sweet dreams	bandoto ya kitoko
sweet	elengi
sweetheart	motema ya malamu
sweet tooth	mino ya sukali
swelling	kovimba
swell	kovimba
swim	kobeta mai
swimming	kobeta mai
swing	dyemba
switch	interrupteur
swollen	kovimba
sword	mopanga
symbol	elembo
sympathy	koyokela mawa
symptoms	bilembo
system	ebongiseli
table	mesa
tackle	kobundisa
tag	kotya eelmbo
tail	mokila
take away	komema
take care	kotya likebi
taken	kozwa
take off	kolongola
take	zwa
talkative	alobaki mingi
talk	koloba
tall	molai
tap	beta
tape	casette
target	eloko bazokana
task	mosala
taste	elengi
tasty	elengi
taught	koteya
teacher	molakisi
teach	koteya
team	ekipe
tear	kopasola
tears	mpinsoli
tease	kotumola
tea	the
technology	teknoloji
teeth	mino
tell	koyebisa
tell me	yebisa nga
temperature	molunge
temper	ezaleli
temple	tempelo
temporary	ntango moke
tenant	moto afutelaka
tendency	memeseno
tender	boboto
tend	momeseno
tense	makasi
tension	kowelana
tentative	komeka
tent	ema
ten thousand	nkoto zomi
ten	zomi
term	liloba
terms	maloba
terrible	ya mabe
terrific	ya mpasi
territory	teritware
test	komeka
text	nkoma
thank	matondi
than	koleka
Thanks for using our app	Matondi ndenge bozosalela programe na biso
thanks	matondi
Thank you for your patience while we investigate shipment	Matondi na motema molai na yo ntango tozalaki kolandela soki batindaki eloko
thank you	matondi
thank you so much	matondi mingi
thank you very much	matondi mingi
that is	elingi koloba
that	oyo
that's good	eza malamu
theft	koyiba
their	bango
them	bango
theme	moto ya likambo
themselves	bango moko
then	na nsima
theory	liteya
there are	ezali
therefore	yango wana
there is	ezali
there	kuna
these	oyo
they are	bazali
they	bango
thick	monene
thief	moyibi
thigh	mipende
thing	eloko
things	biloko
think	kokanisa
thin	moke
third	ya misato
thirsty	mposa ya mai
thirteen	zomi na misato
thirty	ntuku misato
this is	oyo eza
this	oyo
thoroughly	mobimba
thorough	mozindo
those	baoyo
though	atako
thoughtful	ya malamu
thought	likanisi
thoughts	makanisi
thousand	nkoto
thread	nsinga
threaten	kobangisa
threat	likama
three	misato
threshold	ekoteli
thrilled	esengo
thrive	kolonga
throat	mongongo
through	na nzela ya
throughout	na nzela ya
throw	kobwaka
thumb	mosapi ya monene
thunder	makelele ya nkake
Thursday	Mwa Minei
thus	yango wana
tick	kotya elembo
tide	mbonge
tidy	molongo
tie	cravate
tiger	tigre
tight	kokangama
Tigrinya	Tigrinya
time	ntango
timid	nsoninsoni
tiny	moke
tips	batoli
tip	toli
tired	kolemba
tire	pneu
tissue	elamba
title	titre
toast	kotumba
to be	kozala
today	lelo
toddler	bebe
toes	misapi
together	elongo
toilet	wese
told	ayebisaki
tolerance	kokanga motema
tolerate	kopesa nzela
tomato	tomate
tomorrow	lobi
to	na
tongue	lolemo
tonight	lelo na mpokwa
took	kokamata
tool	esaleli
tools	bisaleli
too	mpe
tooth	lino
topic	moto ya likambo
top	likolo
torn	kopasola
torture	konyokola
total	mobimba
touch	kosimba
tough	atako
tour	viziti
toward	na ngambo ya
towards	na ngambo ya
towel	serviette
town	mboka
toxic	ya mabe
trace	elembo
track	nzela
trade	mombongo
traditional	ya mboka
tradition	bokoko
traffic	makambo ya kotambola
trail	nzela
training	mateya
train	koteya
trait	ezaleli
traits	bizaleli
transfer	kotinda esika mosusu
transition	kokende esika mosusu
translate	kobongola
transparent	ezomonana na kati
transportation	transpore
transport	transpore
trap	motambu
trash	mbindo
trauma	mitungisi
travel	kosala mobembo
tray	plato
treasure	bozwi
treat	kosalela makambo
treatment	nkisi
tree	nzete
tremendous	makasi
trend	ezaleli
trial	kosambisa
trick	likanisi
tried	komeka
trigger	kobandisa
trim	kobakisa biloko ya kitoko
trip	mobembo
trouble	mobulu
trousers	pantalon
truck	motuka
true	ya solo
trunk	eteni ya nzete
trust	kotya motema
truth	solo
try	komeka
Tsonga	Tsonga
tube	tiyo
Tuesday	Mwa Mibale
tuition	mbongo ya kelasi
turkey	dindon
turmeric	curcuma
turn	kobaluka
turtle	nkoba
tutor	molakisi
twelve	zomi na mibale
twenty	ntuku mibale
twenty-one	ntuku mibale na moko
twice	mbala mibale
twist	kobuka
Twi	Twi
two	mibale
type	lolenge
typical	ya ndenge wana
ugly	mabe
ultimate	ya nsuka
umbrella	lingembu
unable	kokoka te
uncle	noko
unconscious	kozanga koyeba
under	na nse
underneath	na nse
underrated	komona mpamba
understand	kokanga ntina
understood	kokanga ntina
unfortunately	eza mawa
uniform	ndenge moko
unique	ya kokamwa
unit	eteni
university	iniversite
unknown	eyebani te
unless	longola kaka
until	kino
unusual	esalemaka mingi te
update	ya sika
upgrade	komatisa nivo
up	likolo
upon	na
upset	kosilika
up to you	etali yo
urban	ya engumba
urge	kolendisa
urgent	ya lombango
us	biso
used	kosalela
useful	ya ntina
use	kosalela
useless	kozanga ntina
usually	mbala mingi
usual	mbala mingi
utility	ntina
vacation	congé
vaccination	mangwele
vaccine	mangwele
vacuum	vide
vague	bongobongo
valid	ya malamu
valley	lobwaku
valuable	motuya
value	motuya
variety	ekeseni
various	ekeseni
vary	ekeseni
vase	eloko
vast	mingi
vegetable	ndunda
vegetables	bandunda
vehicle	motuka
vendor	moteki
venom	ngenge
venture	mosala
venue	esika
verify	kotalela
versatile	bongolabongola
version	ya
vertical	ya kotelema
very good	malamu mpenza
very	mpenza
vessel	masuwa
via	na nzela ya
vibe	koningisa
vibes	koningisa
vicious	mabe
victim	victime
video	video
view	kotala
village	mboka
villain	mabe
vinegar	vinaigre
vintage	ya vino
violence	mobulu
violent	mobulu
viral	virisi
virgin	ngondo
virtual	na internet
virtue	ezaleli malamu
vision	emonaneli
visit	kokende kotala
visual	ya komona
vital	ntina
vivid	makasi
vocabulary	maloba
voice	mongongo
void	mpamba
volume	volime
volunteer	mosali ya bolingo malamu
vomit	kosanza
vulnerable	kozanga makasi
wage	salere
wages	basalere
waist	loketo
waiter	serveur
waiting	kozela
wait	zela
wake	kolamuka
wake up	kotelema
walking	kotambola
walk	kotambola
wall	efelo
wallet	potomone
wander	koyengayenga
wanna	nalingi
wanted	kolinga
want	kolinga
war	bitumba
wardrobe	esika ya kobomba bilamba
warehouse	esika ya kobomba biloko
warm	molunge
warning	likebisi
warn	kokebisa
warrior	mobundi
was	ezalaki
wash	kosokola
waste	mbindo
watch	kotala
water	mai
watermelon	pasteque
wave	mbonge
way	nzela
weak	kolemba
weakness	bolembu
wealth	bozwi
wealthy	mozwi
we are	tozali
wearing	kolata
wear	kolata
weather	mopepe
we	biso
we can	tokoki
wedding	libala
Wednesday	Mwa Misato
weed	matiti mabe
weekend	wikende
week	mposo
weight	kilo
weird	mabe
welcome	boyei malamu
welfare	bolamu
well done	longonya
Well	Malamu
went	akendaki
were	ezalaki
west	weste
wet	mai
whale	baleine
what about you	ebongo yo
what are you doing now	ozosala nini sikoyo
what are you doing	ozosala nini
what are you doing right now	ozosala nini sikoyo
what do you do for a living	osalaki nini mpona kozwa bilei
what do you do	ozosala nini
what do you mean	olingi koloba nini
what do you want	olingi nini
whatever	nyonso
what happened	oyo esalemaki
what is	nini eza
what is this	oyo nini
what is your job	osalaka mosala nini
what is your name	nkombo na yo nani
what	nini
what's up	nini ya sika
what's your name	nkombo na yo nani
wheat	ble
wheel	roues
whenever	ntango nyonso
when	ntango
where are you from	owuti wapi
where are you now	oza wapi sikoyo
where are you	oza wapi
whereas	na ntango wana
where do you live	ofandaka wapi
where is	wapi
where	wapi
whether	ezala
which	nini
while	na ntango wana
whisper	konguniangunia
whistle	piololo
white	mpembe
who are you	oza nani
who is	nani aza
who is this	nani oyo
whole	mobimba
whom	nani
who	nani
whose	oyo
why	mpo na nini
why not	mpo na nini te
wicked	mabe
wide	monene
widow	mwasi akufela mobali
width	molai ya moke
wife	mwasi
wild	zamba
will	ako
willing	kolinga
wind	mopepe
window	fenetre
windy	mopepe
wine	vino
win	kolonga
winter	eleko ya malili
wipe	kopangusa
wire	nsinga ya courant
wisdom	bwanya
wise	mayele
wish	kolinga
wish you all the best	natombeli makambo nyonso ya malamu
witch	ndoki
withdrawal	kolongwa
withdraw	kolongwa
with	elongo
within	na kati
without	kozanga
witness	motatoli
witty	elimo
wolf	mbwa ya zamba
woman	mwasi
women	basi
wonderful	kitoko
wonder	kokamwa
won	kolonga
won't	kosala te
wood	libaya
wool	lene
word	liloba
words	maloba
working	kosala mosala
work	mosala
work out	kosala ngalasisi
world	mokili
worm	mosopi
worn	ebeba
worried	komitungisa
worry	komitungisa
worse	mabe koleka
worship	losambo
worst	mabe koleka
worth it	ebongi
worth	ntina
worthy	ebongi
would	ako
wound	mpota
Wow	Wawu
wrap	kokanga
wrath	nkanda
wrist	poignet
Write here	Koma awa
write	kokoma
writing	kokoma
written	kokoma
wrong	mabe
wrote	kokoma
yard	lopango
yawn	makelele ya nyama
Yeah	Ee
year	mbula
years	bambula
yeast	levire
yell	koganga
yellow	jaune
yes baby	iyo bebe
yes dear	iyo ndeko
yes honey	iyo sheri
Yes	Iyo
yes my love	iyo sheri na nga
yes of course	bongo mpenza
yesterday	lobi eleki
yet	atako bongo
yield	kotika
you are beautiful	oza kitoko
you are	ozali
you are so beautiful	oza kitoko mingi
you are welcome	boyei malamu
you can	okoki
You know	Oyebi
young	elenge
you're welcome	boyei malamu
you’re welcome	likambo te
yourself	yo moko
your welcome	boyei malamu
your	ya yo
youth	elenge
you too	yo mpe
you	yo
yummy	elengi
zero	libungutulu
