a	jun
a little	jutz'it
a lot	k'i
a lot of	k'i
abandon	uya'ik kanoq
abandoned	ya'om kanoq
abide	uch'ijik
ability	kowinem
able	kkowin chech ub'anik
about	chi rij ri
above	pa uwi' ri
abroad	pa jun chi tinamit
absence	man k'olem taj
absent	man k'o taj
absolutely	jewi
absorb	utz'ub'ub'exik
abstract	man ka'ilitaj taj
absurd	man jeta kub'ano
abundance	uk'iyal
abundant	uk'iyal
abuse	ub'anik k'ax
abuse	ukojik itzel jastaq
accent	k'osnem
accept	uk'amik
access	okik
access	okem
access	okib'al
access	uya'ik b'e
accident	k'ax riqitajinaq
accommodation	k'olib'al
accomplish	uriqik
accomplished	tz'aqatisam
according	k'amuq'ab'
account	kemb'i'aj
accuracy	suk'il
accurate	suk'
accused	kojom tzijtal chi rij
ache	q'oxom
ache	q'oxom anima
ache	q'oxowik
achieve	uch'akik
achievement	ch'akoj
acknowledge	uya'ik ub'ixik
acquaintance	eta'matalik
acquire	uriqik
acquired	ktajin kinriqo
acquisition	uriqik
across	ktajin kq'axik
act	b'anoj
action	b'anoj
active	k'olik
activities	taq kemb'anowem
activity	b'anoj
actor	ajalib'al
actual	qas tzij
actually	ri qas ub'e'el
acute	nitz'
adapt	uya'ik
add	uya'ik
addicted	k'amanaq che
addition	mulinem
additional	uwi'
address	b'enik
address	achochib'al
address	b'e
address	k'olib'al
address	suk' ub'e
adequate	qas utz
adjacent	kuriq rib'
adjective	q'alb'i'aj
adjust	usuk'maxik
admire	lab'ajinik
admit	uya'ik b'e
adopt	uk'amik
adorable	adorable
advance	nab'ejinaq
advance	b'anom chik
advance	uwa'lijisaxik uwach
advance	uwa'lijisaxik
advance	nab'ejik
advanced	paqalik
advantage	rutzil
adventure	ub'anik uk'amb'ejaxik
adverb	achb'anoj
advertisement	ub'ixik
advertising	ub'ixikil
advice	uya'ik na'oj
advise	na'oj
advocate	tob'anik
advocate	ajch'o'j
advocate	tob'anem
advocate	ch'a'ojinik
aesthetic	ch'umil
affair	ucholajil
affect	kajawaxik
affection	loq'ob'al
afford	k'olem chi unaqaj
affordable	rajilal
afraid	kuxe'j rib'
after	chi rij
afternoon	b'enaq q'ij
afterwards	k'ate ri'
again	jumul chik
against	chi uwach
age	junab'il
agency	wokaj
agent	k'exob'al
aggressive	ka'n
agile	sib'alaj aninaq
ago	chi rij
agree	uk'amik uq'ab'
agreement	k'amuq'ab'
agriculture	tiko'nijik
ahead	chi uwach
aid	tob'anem
aim	retwechixik
air	kaqiq'
airport	kiq'ajb'al xik'ich'ich'
aisle	ok'owib'al
alarm	wane'jb'al
alcohol	tzam
alert	uya'ik ub'ixik
alive	k'aslem
all	konojel
all right	utz la' ne'
all the best	ronojel ri utz
allow	uya'ik b'e
allowed	ya'om b'e chech
almost	wene
alone	xewi
along	pa uq'ijol rech
already	utz chik
Alright	Uk'amik uq'ab'
also	xuquje'
alternative	jun chik
although	pine'
always	amaq'el
am	in
amazing	sib'alaj je'lik
ambiguous	kch'ob'otaj taj
ambition	rayib'exik
ambitious	kraj nik'aj chik
amend	usuk'maxik
amid	chi uxo'l
among	chi uxo'l
among us	chi qaxo'l
amount	uk'iyal
amusing	sib'alaj utz
an	jun
analysis	unik'oxik
ancestors	e qati't qamam
anchor	uya'ik
ancient	ojer
and	xuquje'
and you	chi'l at
angel	ajchikajil winaq
anger	oyowal
angle	tz'uk
angry	oyowal
animal	awaj
ankle	uqul aqanaj
anniversary	na'tajisaxik
announcement	ub'ixikil
annoy	ub'anik k'ax
annoyed	k'ax una'om
annoying	k'ax una'om
annual	chi junab'
anonymous	owatalik
another	jun chik
answer	utojb'alil
answer	uk'ulaxik uwach
answer	utzalijisaxik uwach
answer	tojik
answer	usolik uwach
anticipate	uya'ik ub'ixik apanoq
anxiety	mayowem
anxious	karaj ub'anik
any	apachike
anymore	man kb'an ta chik
anyone	apachike
anything	maj
anyway	apachike ub'antajik
anyways	rech ronojel taq ub'antajik
apart	jun chi peraj
apartment	ja k'olib'al
apologize	uta'ik ukuyik makaj
apparent	ujulaxik
apparently	wene'
appeal	uya'ik uch'a'ik
appear	k'utunsanem
appearance	petib'al
appeared	xinq'alajinik
appetite	rayinem
apple	mansa'n
application	tz'onoj
apply	ukojik
appointment	sik'inem
appreciate	uloq'oxik
appreciation	uya'ik q'ij
approach	qatem
approach	rilik
approach	q'atenik
approach	oqanik
approach	opanem
appropriate	qas utz che
approval	uya'ik b'e
approve	uk'amb'ejaxik
approved	ya'om b'e chech
approximately	petinaq aq'anoq
april	ukaj ik'
arbitrary	man jetaj
architect	k'uttz'aqonel
architecture	k'uttz'aqonem
archive	uk'olik
are	are'
are you	at k'o at
are you busy	man jamal ta awach
are you married	at k'ulan chik
are you married or single	at k'ulanik on man at k'ulan taj
Are you still there?	¿La at k'o na chla'?
are you there	at k'o chla'
area	uqajb'al
argue	tzijonem
argument	kolomal
arise	kamajix aq'anoq
arm	ch'u'k
army	chajinel
around	chi rij ri
arrange	ub'anik rutzil
arrangement	b'anom ub'anik
arrival	opanem
arrive	opanem
arrived	xinulik
arrogant	nimal
arrow	ch'ab'
art	uje'lal chak
article	jastaq
artificial	man tzij taj
artist	ajb'ix
as	pacha'
as long as	are taq
as well	xuquje'
as well as	sib'alaj utz pacha'
ash	chaj
ashamed	kak'ixik
ask	uta'ik
asked	xinto
asleep	warnaq
aspect	upetib'al
Assamese	Assamese
assault	ch'ayanem
assembly	uwokik
assertive	qas utz
assess	uk'amb'ejaxik
assessment	upajik rij
asset	k'olem
assets	e k'olik
assign	uya'ik
assignment	chak
assist	rilik
assistant	tob'anel
associate	uya'ik
associated	ya'om
association	uya'ik
assume	uk'amik
assumption	kb'an che
at	pa
at least	ruk' we
ate	xintij nuwa
athlete	ajtikolanim
attach	uya'ik
attached	k'o ruk'
attachment	ya'om ruk'
attack	tzurunem
attempt	ub'anik chi jumul
attempt	ub'anik
attempt	ukojik chi chuq'ab'
attempt	kojik chuq'ab'
attend	k'olem
attendance	k'olem
attention	utatab'exik
attitude	ub'antajik
attract	k'amik loq
attraction	ilonem
attractive	sib'alaj je'l
attribute	ub'anik
audience	tzijonem
august	uwajxaq ik'
aunt	ch'utinan
aunty	ch'utinan
authentic	qas are'
author	ajno'j
authority	taqanel
autumn	saq'ij
available	jamal uwach
average	uk'u'x ajilab'al
avoid	uq'atik
awake	k'ask'atem
award	ch'akoj
aware	kuchomaj rij
awareness	k'oxomab'al
away	naj
awesome	maj jewi
awful	sib'alaj k'ax
awkward	man utz ta k'o wi
Aymara	Aymara
baby	ne'
bachelor	man k'ulan taj
back	chi rij
background	b'anom kanoq
bad	itzel
bag	k'olib'al jastaq
bait	chab'al re
bake	umeqsaxik
bakery	b'anb'al kaxlan wa
baking soda	b'ikarb'onat
balance	uya'ik utojb'al
balance	ch'akik
balance	ch'akoj
balance	sowr
ball	potz'
Bambara	Bambara
banana	ankane'y
band	uchi'
bang	poq'ik
bank	ja k'olpwaq
bar	bar
barely	k'ate
bargain	uqasaxik rajil
bark	tyo'nik
bark	tyo'nem
bark	uraqik chi'aj
barley	seb'ad
barrier	q'ateb'al
base	uxe'al
based	petinaq chech
basement	uxe' ja
basic	qas kachokonik
basically	qas jewi
basil	albahaca
bastard	b'anal etzelal
batch	juperaj
bath	ch'ajo'nib'al
bathroom	eleb'al
battery	k'olq'aq'al
battle	ch'o'jinem
bay	utza'm ulew
be	k'olem
be careful	utz rilik kb'anik
beach	uchi' polow
beam	juxk'inem
beans	kinaq'
bear	uya'ik
bear	uch'ijik
bear	ya'onem
bear	uk'amik
bear	k'amonem
bear	chajinem
beard	ismachi'
bearing	na'ojinem
beast	Nim chikop
beat	q'ojom
beat	uq'osixik
beat	uch'akik
beat	b'anik
beat	ch'a'ik
beautiful	je'lik
beauty	petib'al
became	xintzalijik
because	rumal
become	tzalijem
bed	ch'at
bedroom	warab'al
bee	wonon
beef	ti'ij
been	b'anowinaq
beer	tzam
before	mojo'qa che
began	xinmajij
begin	umajik
beginning	majib'al
behalf	rech ri
behave	utz no'jinem
behavior	no'jib'al
behaviour	no'jib'al
behind	chi rij rech
being	are taq
belief	kojonb'al
believe	kojonik
belly	pamaj
belong	rech are'
beloved	loq'olaj
below	chi uxe'
belt	ximob'al
bench	che' t'uyulb'al
bend	uq'ochik
beneath	chi uxe' rech
benefit	tob'anem
benefit	pataninik
benefit	tob'anik
benefit	pataninem
benefits	ri kaya'ik
beside	rachi'l
besides	xuquje'
best	qas utz
best of luck	sib'alaj k'o ch'akanem
best regards	ruk' k'ixb'al
better	qas utz
between	chi uxo'l
beverage	uk'ya'
beyond	k'a jela'
Bhojpuri	Bhojpuri
bias	qas kajawatajik
biased	k'o uq'ijol
bicycle	let'et'
bid	utzujuxik
big	nim
bike	let'et'
bill	uwujil tojonik
bind	jat'inem
bird	tz'ikin
birthday	utz'aqatisaxik junab'
bit	jutz'it
bite	qarinem
bite	kayenem
bite	tojonem
bite	qarinik
bite	kayenik
bite	tojonik
bitter	k'a
black	q'eq
blade	uxaq
blame	uya'ik ub'ixik che
blame	uya'ik ub'ixik
blame	ub'anik makaj
blame	makaj
blank	pa saqil
blanket	q'u'aj
blast	kaqulja
bleach	b'anb'al saqilal
blend	uyujik
bless	tewechib'al
blessed	tewechi'talik
blind	moy
bliss	ki'kotemal
block	kaxlan xan
blood	kik'
bloom	kotz'i'j
blow	uxut'ixik
blue	raxkaj
blunt	man b'anom ta uware
board	tz'alam
boat	nim jukub'
body	ch'akul
boil	upoq'owsaxik
bold	chaqab'
bond	kolob'
bone	b'aq
book	tz'ajanik
book	tzajb'al wuj
book	wuj
book	uk'olik
book	chuch wuj
boost	wa'lijisanem
boost	paqab'anem
boost	upaqab'axik
boost	wa'lijisaxik
booster	uya'ik uchuq'ab'
boot	b'otax
boots	taq b'otax
border	monjon
bore	q'itajik
bored	maj karaj kub'ano
boring	k'o ta kraj kub'ano
born	alaxinaq
borrow	uqajik
boss	k'amal b'e
both	kab'ichal
bother	ub'anik etz'anem
bottle	lame't
bottom	wachretal
bought	xinloq'o
bounce	upixk'ansaxik
bound	taqchital ub'anik
boundaries	monjon
bow	pachalem
bowl	b'as
box	kajxkut
boy	ak'al
boyfriend	k'ulaj
bracelet	qulq'ab'
brain	tzantzaq'or
branch	uq'ab'il
brand	retal
brave	k'an
breach	q'ajq'ob'em
bread	kaxlan wa
break	upaxixik
break	ri q'atb'altzij
break	uxlanik
break	uxlanem
breakfast	wa rech nimaq'ab'
breast	uwach k'u'xaj
breath	uxlab'
breathe	ujek'ik kaqiq'
breed	upetib'al
brick	porom xan
bride	k'ulaj
bridge	q'axeb'al
brief	xaq ko'lik
bright	sib'alaj katz'ajlinik
brilliant	kachuplinik
bring	uk'amik loq
bro	achalal
broad	uwach
broadcast	uq'axexik apanoq
broke	paxim
broken	paxinaq
broom	meseb'al
brother	achalal
brother in law	b'aluk
brought	nim atz'yaq
brown	kape
brush	ujosq'ixik ware'aj
bucket	kwet
buddy	achi'l
budget	urajilal chak
bug	q'upunel
build	uwokik
building	nim ja
built	wokotalik
bulk	eqa'n
bull	ama' wakax
bully	ub'anik bully
bump	tzaqem
bunch	racimo
bundle	eq'an
burden	eqa'n
burden	reqaxik
burden	k'olq'aq'al
buried	muqum
burn	poroxik
burst	puk'inem
bury	umuqik
bus	ch'ich' ereb'al winaq
bush	b'e'nche'
business	k'ayinem
bust	wachib'al
busy	man jamal ta uwach
but	xa k'ut
butter	manteka'
butterfly	pepe
button	pitz'b'al
buy	loq'ik
by	rumal
by the way	xa k'u cha'
bye	jeb'a'
cabbage	repo'y
cabinet	k'olib'al jastaq
cage	ko'k
cake	ch'uch'uj kaxlanwa
calf	upa'a'
call	ch'awem pa ch'aweb'al
call	ch'awik
call	sik'inem
call	ub'ixik
call	sik'inik
call	b'ixik
call me	chinach'ab'ej
called	xinsik'ij apanoq
calm	eye'nem
came	impetinaq
campaign	yaktzijol
can	kowinik
can	kowinem
can	chuq'ab'enik
can	tqanik
can	taqanem
can	chuq'ab'il
can't	man kb'an ta kowinem
Cancel	Uq'atexik
cancer	q'aynaqil yab'il
capable	kowinem
capacity	kuch'ijo
capital	nim tinamit
caption	ral k'utb'al q'atoj
capture	uchapik
car	ch'ich'
career	tijowanim
careful	no'jimalil
carefully	no'jimal
careless	man ilom taj
caring	ajloq'
carpenter	ajanel
carpet	upopil upaja
carrot	q'anichaj zanja
carry	uk'amik b'ik
carry on	terne'xik
carry out	kb'an na
case	kaso
cash	ruk' pwaq
cast	uwinaqil
castle	tz'u'q ja
casual	kub'ana wi na
cat	me's
catch	chapanik
category	ub'antajik
cattle	awajib'
caught	xinchapo
cause	b'anoj
cause	jas che
cause	k'ulmatajem
cause	k'ulmatajik
cause	ub'anik
caution	q'ilb'al
cautious	kuchajij rib'
cave	pek
cease	ujamarisaxik
ceiling	uwi ja
celebrate	uya'ik una'tajisaxik
cell	k'ajk'as
center	uk'u'x
century	ab'
cereal	t'orotaq ija'
ceremony	nimaq'ij
certain	tzij
certainly	qas tzij wi
certificate	uya'ik utz'ib'axik
chain	k'amchachal
chair	tem
challenge	kb'an na
chance	chak
change	uk'exik
chaos	sachem
character	winaqil
characteristics	taq ub'antajik
charge	uya'ik
charity	tob'anem
charming	b'anal mayijab'al
chart	kajxukut
chase	uterne'xik
chat	tz'ib'anik
chat	tzijonem
chat	tz'ib'anem
chat	tzijonik
cheap	man paqal ta rajil
cheat	ub'anik tzij
cheating	b'anoj k'ax
check	rilik yab'il
check	uk'amb'ejaxik
check	rilik
cheek	palaj
cheer	usilab'axik
cheerful	tze'tzotem
cheers	utzwachil
cheese	Keso
chemistry	eta’mab’alil tz’aqatil jastaq
cherish	retwechixik
chess	ajedrez
chest	uwach k'u'xaj
chew	kach'unem
chicken	ak'
chief	k'amal b'e
child	ak'al
childhood	ak'alal
children	ak'alab'
chill	xut'inem
chill	q'aq'tewal
chill	k'o ta kb'anik
chill	jorob'sanem
chimneys	releb'al taq sib'
chin	kakte'
chocolate	kab'
choice	cha'onem
choose	ucha'ik
chop	pa'inem
chores	b'anoj
chubby	alaj chom
church	tyox ja
cinnamon	kanel
circle	ketekik
circumstances	jastaq
citizen	winaqil
city	tinamit
claim	uya'ik uch'a'ik
claim	usuk'ub'axik ub'ixik
claim	uch'a'ik
claim	ajawanem
clarify	uq'alajisaxik
class	b'antajik
clay	kach'ulew
clean	ch'ajch'oj
clear	q'alaj
clear	uq'alajisaxik
clear	kq'alajin upam
clerk	t'iqitalik
clever	utz chik
client	loq'omanel
cliff	swan
climate	miq'tewal ulew
climb	paqalem
clingy	suk'umam
clock	etal q'ij
close	utz'apixik
closet	k'olib'al atz'yaq
cloth	taq atz'yaq
clothes	atz'iyaq
cloud	sutz'
cloudy	sutz'
clown	ajyakol tze'
clue	etz'anib'al
clumsy	xaq katzaqik
cluster	kluster
coach	tijonik
coach	ajtij
coach	tijonel
coal	aq'a'l
coast	taq'aj
coat	pim atz'yaq
coffee	kape
cognitive	k'oxomanem
coincidence	k'oxomab'al
cold	tew
collapse	tzaqik
collar	chachal
colleague	achi'l
colleagues	achi'l
collect	umulixik
collection	ucha'ik
college	nim tijob'al
color	tz'ajb'al
colorless green ideas slept furiously	ri rax taq na'oj man kel ta utz'ajb'al utzalaj waram kkib'ano
colour	tz'ajb'al
column	tak'al juch'
comb	uxiyik wi'aj
combination	uyujik
combine	uxo'laxik
come	petem
come here	tojo waral
come on	jo'
comfort	utzalaj k'olem
comfortable	sib'alaj utz
coming	jun chik
coming soon	petinaq aq'anoq
command	taqanik
comment	utzijoxik rij
commercial	k'aywokaj
commission	tojb'alil
commit	ub'anik
commitment	rajawaxik kb'anik
committed	uya'om uchi'
commodity	utz k'owi
common	k'o uch'a'ik
communicate	tzijonem
communication	tzijonem
community	wokaj
commute	b'yajem pa ri chak
companion	achi'l
company	k'aywokaj
compare	ujunamaxik
comparison	ujunamaxik
compassion	toq'ob'sanem
compassionate	k'o ukoch'onik
compatible	uk'ulaj rib'
compete	uterne'xik ch'akanem
competent	qas ka'ilowik
competition	riqonem
competitive	kraj kch'akanik
complain	uya'ik uch'a'ik
complaint	uch'a'ik
complement	tz'aqatenem
complement	tz'aqatil
complement	utz'aqatisaxik
complement	ya'onem
complete	utz'aqatisaxik
completely	tz'aqatem
complex	k'ax
compliance	uya'ik uch'a'ik
complicated	k'ax uchomaxik
compliment	tz'aqatisam
comply	utz'aqatisaxik
composition	utz'ib'axik
compound	b'anom k'aj che
comprehension	ch'ob'onem
comprehensive	tz'aqat
compromise	k'ulanem
compromise	rajawaxik kb'anik
compromise	uya'ik ub'ixik che tzij rajawaxik kb'anik
compulsory	qas rajawaxik wi
computer	kematz'ib'
concentrate	ukojik chomanem
concept	ri kub'ij
concern	ukojik
concern	mayowem
concern	mayowik
concern	petinaq chech
concerned	kmayowik
concert	q'ojomanem
conclusion	uk'isb'alil
concrete	qas are'
concrete	tz'aqatisaxik
concrete	qas tzij
concrete	tz'aqatisam
condition	kajawataj chech
conditions	taqanem
conduct	no'jinem
conference	tzijonem
confess	uq'alajisaxik
confidence	uq'alb'al k'u'x
confident	k'o uch'ijb'al
confirm	usuk'ub'axik
conflict	ch'a'oj
confused	man kuch'ob' ta ub'anik
confusion	sachem
congrats	ki'kotemal awech
congratulation	uya'ik kikotemal
congratulations	utz awech
conjunction	nuk'ik
connect	ut'iqik
conquer	ub'ochi'xik
conscious	k'o uk'oxomab'al
consciousness	kch'omanik
consent	ya'ik
consent	k'olem ruk' chi winaq
consent	uya'ik b'e
consent	k'olik
consequences	umak
conservation	utasik apanoq
conservative	k'olonel
consider	uch'ob'ik
considered	xinch'ob'o
consist	ruk'a'am
consistency	junamil
consistent	k'o uk'oxomab'al
constant	amaq'el
constantly	amaq'el
constipation	q'ululem pamaj
construction	uwokik
consume	utijik
consumption	ukojik
contact	chapanik
contact	ajch'ab'e'n
contact	uch'ab'exik
contact	chapanem
contagious	koqanik
contain	ruk'a'am
contains	ruk'a'am
contemporary	kamik
contempt	itzel kaye'nem
content	upam chak
contest	opanriqonem
context	upam chak
continent	continente
continue	ub'anik na
contract	uchokik
contract	chak patan
contract	k'amuq'ab'
contrast	uq'alajilal
contrast	ukojik q'eqsaqilal
contrast	qeq'saqilal
contrast	saqil
contribute	tob'anem
contribution	tob'anem
control	rilik
controversial	ch'o'jinem
convenience	ri karaj
convenient	are tzu che
conversation	tzijonem
convert	jalk'atinik
convert	jalk'atinem
convert	q'axexik
convert	q'axenem
convey	ub'ixik
convince	ukojik upam
convinced	uch'akom che ranima
cook	unuk'maxik
cook	ub'anik wa'
cook	nuk'maxik
cook	b'anal wa
cooking	b'anb'al wa
cool	uq'alb'al k'u'xaj
cool	utz
cool	jororem
cool	sib'alaj utz
cool	maj jewi
cool	ujorob'asaxik
cooperation	tob'anem
cope	uxalq'atixik
copper	kaqakach’ch’ich’
core	uk'u'xal
corn	ixim
corner	xukut
correct	qas tzij
cost	rajilal
cost	k'ax ub'anik
costume	atz'yaq
cottage	alaj ja
cotton	b'ot
couch	nima tem
cough	qulaj
could	wene
council	na'oj
count	rajilaxik
counter	k'utb'al
country	amaq'
countryside	k'olib'al
couple	k'ulajil
courage	kowinem
course	eta'manem
court	q'atb'altzij
courtesy	k'o uk'ixb'al
cousin	ch'utiwachalal
cover	uchuq'ik
cow	wakax
coward	man kuk'ut ta rib'
cozy	sib'alaj utz
crab	tap
crack	paxe'l
crack	paxixik
crack	paxinem
craft	manualidad
crap	achaq
crash	paqchixik
crash	paqchinem
crash	paq'inem
crash	paq'ixik
craving	munil
crawl	chakanem
crazy	pay
create	uwinaqirisaxik
creative	k'o uchomab'al
credit	qajanem
creep	chararexik
creepy	xib'ib'al
crew	winaqil
crime	makaj
cringe	pachalik
cringe	xib'in ib'
cringe	rech k'ixb'al
cringe	xib'inik
crisis	wi'jal
criteria	ub'antajik
critical	kaxk'olil
criticism	ucha'ik rij
crop	tiko'n
crops	taq tiko'n
cross	q'axem
cross	kruz
cross	q'axenik
cross	ok'owem
crow	joj
crowd	uk'iyal winaq
crowded	kub'ana ta chik
crown	q'alwach
crucial	pa'italik
cruel	sib'alaj k'ax
cruise	wa'katem
crush	uwach'ik
crush	chapik
crush	k'iyal
crush	wachik'ik
crush	k'iyanik
crush	pach'anik
crush	upach'ik
cry	oq'ej
cucumber	pepin
cuddle	matzexik
culture	b'antajik
cunning	kub'an wi
cup	alaj xa'r
cupboard	k'ayib'al
curb	uchi'
cure	ukunaxik
cure	rilik
cure	ukunab'alil
cure	kunanem
cure	kunanik
curfew	ramaj rech man kb'an ta elem
curiosity	kraj kareta'maj
curious	karaj reta'maxik
curly	Koloch
currency	ch'ich' pwaq
current	kamik
currently	kamik
curse	itzelal
curtain	atz'yaq ch'uqsaqil
cushion	alaj tem
custom	naq'tisam ub'anik
customer	loq'omanel
customs	taq uqajb'al xik'ich'ich'
cut	sokotajik
cut	raminem
cut	sokotajem
cut	ramixik
cute	je'lik
cycle	k'utunsanwachib'al
cycling	cholkejen ch'ich'
dad	tat
daddy	tat
daily	chi q'ij
dairy	uwa'l tu'
dam	tapya
damage	ub'anik k'eyowal
damage	ub'anik k'ax
damn	kaxk'ol
damp	raxqinilik
dance	xojowem
danger	kub'an k'ax
dangerous	rech k'axk'ol
dark	q'equ'm
darling	loq'alaj
dash	rab'juch'
data	rajilb'alil q'ij
date	sik'inem
date	rajilb'alil q'ij
date	uq'ijol
daughter	mi'al
day	q'ij
dead	kaminaq
deadline	uk'isb'al q'ij
deaf	tokon
deal	uya'ik
deal	uchomaxik
deal	ri uya'ik
deal	ri k'amuq'ab' chak
deal	chomanem
dear	loq'alaj
Dear All	Loqalaj
Dear Customer	Loq'olaj loq'omanel
Dear Parents	Loq'alaj taq tat nan
Dear Sir	Loq'alaj Tat
Dear students	Loq'alaj taq tijoxelab'
Dear Team	Loq'alaj taq wokaj
death	kamikal
debate	uch'ojimaxik
debit	k'asaj
debris	utz'aqat
debt	k'asaj
decade	q'ijol
decay	teq'etob'ik
deceased	kaminaq
deceive	ub'anik tzij
december	ukab'laj ik'
decent	suk'
decide	uchomaxik
decided	xinchomaj
decision	chomanem
deck	ropanib'al jukub'
decline	man kyta ta b'e
decrease	unitz'arisaxik
dedicated	qas uchakum
dedication	qajnem
deed	tz'ib'
deep	nim qajinaq
deer	masat
default	pacha' ya'om loq
defeat	b'anom
defeat	uriqik
defeat	ub'anik
defeat	uriqik k'ax
defend	uto'ik
define	rilik
definitely	junelik wi
definition	kel kub'ij
degree	tan
delay	rech kutan
delay	b'eyonem
delay	b'eyik
delayed	elenaq kanoq
delete	uchupik
deliberate	uchomaxik
delicate	ch'in
delicious	utz una'ik
delight	placer
delighted	nim karil wi
deliver	uya'ik
delivered	ya'om
delivery	rech uya'ik
demand	uch'ojixik
demand	chokonem
demand	ukojik tzij
demand	chokonik
demanding	kuch'a'o
democracy	tzoqopinem
demon	itzel uxlab'al
demonstrate	uk'utunsaxik
denied	ya'om ta b'e chech
density	unimal
dentist	ilol ware'aj
deny	man kya ta b'e
department	nim tinamit
departure	elem
depend	kajawataj na jun
deploy	uq'axexik
deposit	uya'ik
deposit	ya'onem
deposit	k'ayib'al jastaq
deposit	ya'onik
deposit	k'olib'al
depressed	q'itajinaq
depression	swan
depth	nim upam
describe	uya'ik usaqil tzij chi rij
description	uq'alajisaxik
desert	tz'inilik ulew
deserve	qas uch'akom
design	petik
design	uwokik
design	petib'al
design	wokob'al
designation	ub'i'
desire	kwaj
desire	ajawatajik
desire	ajawanem
desk	mexa
despair	desesperación
desperate	karaj taj jas kub'ano
despite	ruk' taq ri
dessert	k'olib'al katz'inowik
destination	ropanib'al
destiny	opanib'al
destroy	uwulixik
destruction	uwulixik
detail	ucholajixik
details	taq cholajil
detect	rilik
determination	rilik
determine	rilik
determined	ilom
devastated	yujum uk'aslemal
develop	uya'ik ub'ixik
developed	b'anom ub'anik
development	uwa'lijisaxik uwach
device	wiqkemchakub'al
devil	itzel
devoted	b'anom toq'ob' che
Dhivehi	Dhivehi
diabetes	ki'arik kik'
diarrhea	torotajem pamaj
diary	chi q'ij
dictionary	choltzij
did	xinb'ano
die	kamik
died	kaminaq
diet	chatal wa'im
difference	uk'exb'alil
different	jalan wi
difficult	k'ax
dig	uk'otik
dignity	loq'ob'al aq'anoq
diligent	kojom
dinner	wa rech b'enaq q'ij
dip	pix
direct	uk'amik b'e
direction	achochib'al
director	k'amal b'e
dirt	tz'il
dirty	tz'il
disable	uya'ik kan yab'yoj
disabled	yab'yoj
disappear	sachanem
disappointed	man utz ta rilom
disaster	k'eyowal
discard	relesaxik
discharge	uya'ik relem b'ik
discipline	taqanem
discount	uqasaxik rajilal
discover	uriqik
discrimination	retzelaxik
discuss	uch'a'ik
discussion	tzijonem
disease	yab'il
diseases	taq yab'il
disguise	patzka'rem
disgusting	tzel una'ik
dish	rikil
dishes	taq wa'b'al
dismiss	relesaxik b'ik
dispatch	utaqik
display	uk'utunsaxik
disposal	maj upatan
dispute	ch'a'oj rij
distance	uxo'l
distinct	jalan wi
distinguish	ujachik uwach
distress	q'oxowem
distribution	ujachik
district	k'olib'al
disturb	uq'atik
ditch	ub'e ja'
dive	puq'inem
diverse	jalajoj
diversity	jalajoj uwach
divide	upa'ixik
divine	maj jewi
divorce	jachanem
divorce	jachanik
dizzy	muluw k'u'x
do	ub'anik
do you	at
do you love me	kinawaj
doctor	ajkun
document	wuj
does	b'anik
doesn't	ja'i'
dog	tz'i'
Dogri	Dogri
doing	ktajin ub'anik
doll	ala's
domain	rajaw kemk'at
domestic	chi uwaja
dominant	are qas kb'an rech
don't	ja'i'
Don't worry	Man k'o ta kamayo
donate	usipaxik
done	b'anom chik
donkey	b'ur
dope	q'ayes
double	kamulim
double	ukamulixik
double	keb' uwach
doubt	mayowem
doubt	mayowik
dough	q'or
down	chi uxe'
download	uqasaxik
draft	chupb'al
draft	machot
draft	ub'anik jun chuptz'ib'
draft	alaj chuptz'ib'
drag	uchararexik
drain	ub'e joron
drama	drama
draw	utz'ajik
drawer	kaxon
drawing	tz'ajanik
dread	xib'in ib'
dream	kraj kub'an jun q'ij
dream	achik'ik
dream	waram
dress	karatz'yaqisaj rib'
drill	worob'al
drink	qumuxik
drink	qumunik
drink	uk'ya'
drink	utijik jastaq
drive	ub'inisaxik ch'ich'
drop	tz'uj
drop	uya'ik tzaqik
dropped	elesam kanoq
drought	chaqijorem
drunk	q'ab'arel
dry	chaqi'j
duck	patax
dude	ub'antajik
due	rumal
due to	rumal che
dull	nim taj
dumb	kchob'on taj
dump	k'olb'al mes
duration	uq'ijol
during	are taq
dust	ulew
duty	rajawaxik kb'anik
dwell	k'olem
dying	kosib'al
each	chi
each other	chi jujun
eager	kraj kub'ano
eagle	xik
ear	xikin
earlier	sib'alaj aq'ab'il
early	aq'ab'il
earn	uch'akik
ears	taq xikin
earth	uwachulew
earthquake	nim keb' raqan
ease	man k'ax ta ub'anik
easily	man k'ax taj
east	releb'al q'ij
easy	man k'ax taj
eat	wa'ik
eating	wa'ik
economic	meb'a'il
economy	meb'a'il
edge	chi uchi'
edit	uk'exsuk'umaxik
education	tijonem
effect	mayib'al
effective	qas utz
efficiency	sak'aj
efficient	qas utz
effort	ukojik chuq'ab'
egg	saqmo'l
eggplant	q'eqichaj
ego	nimal
eight	wajxaqib'
eighteen	wajxaqlajuj
eighty	jumuch'
either	on
elaborate	unuk'maxik
elbow	ch'u'kaj
elder	ri'j winaq
elderly	nim winaq
elegant	je'lik
element	tz'aqatil
elephant	tix
eleven	julajuj
eligible	utz kacha'ik
eliminate	uchupik
else	nik'aj chik
embarrassed	kak'ixik
embarrassing	k'ixb'al rilik
embrace	laq'apuxik
emerge	mub'anem
emergency	aninaqil rij
emotional	nab'alil
empathy	tob'anem
emphasis	chuq'ab'ib'al
emphasize	chuq'ab'ixik
employee	ajchak
employees	ajchakib'
employer	k'aywokaj
employment	chak
empty	jamal upam
enable	jamal uwach
encounter	uriqik
encourage	ukojik chuq'ab'
end	uk'isb'al
endangered	k'o pa k'eyowal rech uchupik uwach
endeavor	chuq'ab'il
endurance	uchijkil
endure	ukolik k'aslemal
enemy	k'ulel
energy	kaxlan q'aq'
engage	uya'ik ub'ixik che kb'anik
engaged	kub'an wi
engagement	rajawaxik kb'anik
engine	yab'al uchuq'ab'
engineer	ajpuqno'jib'al
English	Inglés
enhance	ub'anik utz che
enjoy	ki'kotem
enormous	sib'alaj nim
enough	ke'ub'ana'
ensure	utz rilik kb'anik
enter	okem
entertainment	naq'tisaxik
enthusiasm	entusiasmo
enthusiastic	ki'kotem
entire	tz'aqat
entitled	kojom ub'i'
entity	wokaj
entrance	okib'al
entrepreneur	Nimalaj ajk'ay
envelope	chi rij
environment	ulewal
envy	ti'tikil
epic	maj jewi
epidemic	suqyab'il
equal	junam
equipment	chakub'al
equity	q'inomalil
equivalent	junam
eraser	chuptz'ib'
error	sachem
escape	elem b'ik
especially	qas are'
essay	te'taliknem
essence	uk'u'x
essential	qas rajawaxik wi
establish	ukojik
established	kojom
estate	ub'antajik
estimate	retwechixik
estimated	loq'alaj
etc	nik'aj chik
eternal	junelik
ethics	ética
evaluate	uk'amb'ejaxik
evaluation	upajik rij
even	pine'
even though	pine' are taq
evening	chaq'ab'
event	k'ulmatajem
eventually	chi jantaq
ever	k'o jumul
every	chi
everybody	ronojel
everyone	konojel
everything	amaq'el
evidence	b'anoj
evil	itzel
evolution	k'extajem
evolve	uk'exik
Ewe	Ewe
ex	ex
exact	jela'
exactly	je k'u la'
exam	k'amb'ejanem
examine	utzukuxik
example	k'amb'ejab'al tzij
exceed	q'axnaq chik
excellent	sib'alaj utz
except	ruk' we
exception	man chi'l taj
excess	q'axnaq chik
excessive	sib'alaj kaq'axik
exchange	k'exonem
excited	ki'kotem rech
excitement	na'b'alil
exciting	sib'alaj ki'kotemal
exclusive	xew rech
excuse	tzukum tzij
excuse me	kuyu'
execute	uchakuxik
execution	uchakuxik
executive	Nim reqele'n
exercise	b'anik
exercise	chak patan
exercise	unaq'tisaxik ub'anik
exhaust	uk'isik
exhausted	kosinaq
exhibit	uya'ik apanoq
exhibition	uk'utik
exist	k'olik
existence	k'olik
existing	k'o chik
exit	eleb'al
expand	unimarisaxik
expect	reye'xik
expected	ktajin reye'xik
expenses	uchupurik pwaq
expensive	paqal rajil
experience	k'o reta'mab'al
experience	eta'manem
experience	rilik uta'ik
experience	reta'maxik
experiment	ktajin rilik
expert	ajsaqwachom
expired	k'isnaq uq'ijol
explain	uq'alajisaxik
explanation	uya'ik uq'alajisaxik
exploit	unik'oxik
explore	unik'oxik
export	utaqik b'ik
expose	uya'ik ub'ixik
exposed	ya'om apanoq
exposure	uq'alajisaxik
express	aninaqil
expression	ub'ixik
extend	unimarisaxik
extended	nimarisam
extension	raqan uq'ab'
extent	uq'ab' utza'm
external	elenaq b'ik
extinct	k'o ta chik
extra	extra
extract	relesaxik
extraordinary	maj jewi
extreme	utza'm
extremely	sib'alaj
eye	b'aqwachaj
eyes	b'aq'wachaj
fabric	atz'yaq
fabulous	sib'alaj je'lik
face	cholk'aslemal
face	palaj
face	ub'ixik chi upalaj
facilitate	uya'ik
facilities	ukojik
facility	jeqeb'anem
fact	makaj
factor	ajalib'al
factory	wokob'al
facts	taq b'anoj
fade	uq'oq'otexik
fail	k'ax
fail	ub'anik k'ax
fail	man xkowinb'ex ta ub'anik
failed	xinsachik
failure	man utz ta ub'anom
faint	sutinwachaj
fair	utza pajb'al
fair	q'alaj
fair	utz uk'aslemal
fair	suk'
fairly	suk'
fairy	ada
faith	kojb'al
faithful	suk'
fake	man je taj
fall	q'ajik
fall	tzaqem
fall	qajem
fall	tzaqik
fall	man itz ta rilik
FALSE	MAN TZIJ TAJ
fame	k'o uch'a'ik
familiar	ajupaja
family	ajupaja
famine	k'o numik chaqij chi'
famous	k'o uch'a'ik
fan	xut'ib'al
fancy	utz upetik
fantastic	maj jewi
far	naj
farewell	uk'isb'alil
farm	awajib'al
farmer	ilol awajib'
fascinating	je'l upetik
fashion	moda
fast	aninaq
fat	chom
fatal	sib'alaj k'ax
fate	ropanib'al
father	tat
fatigue	kosem
fault	karaj na
favorite	ajawatalik
favour	jun toq'ob'
favourite	ajawatalik
fear	paqab'anem
fear	upaqab'axik
fear	b'anik
fear	xib'in ib'
fear	kraj taj kub'ano
feast	nimaq'ij wa'im
feather	rismal awaj
feature	petik
feature	k'utunsanem
feature	ub'antajik
feature	petem
feature	uk'utik
feature	k'utunsanik
features	ub'antajik
february	ukab' ik'
fed up	ya'om uwa
fee	rajilal
feed	utzuqik
feedback	kamul uk'utik
feel	na'ik
feeling	na'b'alil
feet	aqan
fell	tzaqik
fellow	achi'l
felt	xin na'o
female	ixoq
fence	koral
fertile	utz kb'an tiko'nijik
festival	nimaq'ij
fetch	uk'amik loq
fever	q'aq'
few	k'i taj
fewer	man k'i taj
fiance	uya'om uchi'
fiction	man tzij taj
field	uqajb'al
fierce	b'anal k'ax
fifteen	jo'lajuj
fifty	kawinaq lajuj
fight	ch'a'ojinem
fight	uwa'lijisaxik uwach
fight	ukojik chuq'ab'
fight	ch'a'ojinik
fighting	ch'a'oj
figure	ajilab'al
figure	ukojik rajilal
figure	unimal
figure	pwaq
figure out	usolik uwach
file	kemk'olib'al
fill	unojisaxik
filled	nojisab'al rech
film	k'olsilob'wach
filthy	tzel rilik
finally	chi uk'isb'al
finance	upetik ameb'a'il
financial	pwaqilal
find	uriqik
find out	usolik uxe'
fine	utz
fine	q'atoj tojonik
fine	kachokonik
fine	ch'uch'uj
finger	uwi q'ab'aj
finish	uk'isik
finished	k'isom
fire	q'aq'
firm	tak'alib'al
firm	ujuch'ik
firm	suk'
firm	juch'b'i'aj
first	nab'e
first name	nab'e b'i'aj
fish	kar
fit	kub'ano
five	job'
fix	ub'anik rutzil
fixed	jeqom
flag	etal atz'yaq
flash	jumul usachanik
flat	ja k'olib'al
flat	li'anik
flat	liya'nik
flat	uk'uwachib'al ri ja
flat	k'utwachinik
flaw	k'o k'ax che
flawless	maj jewi
flee	animajem
flesh	ti'ij
flew	xinxik'ik'ej
flex	utz ukotik
flexible	man ko taj
flight	b'enam pa xik'ich'ich'
flip	uya'ik sutinem
flirt	k'aqa't
flirting	k'aqa't
float	li'owem
flood	mub'anik
floor	tan
flour	k'aj
flow	utijik anim
flower	kotz'i'j
flu	yab'il jolomaj
fluent	utz ub'inem
fluently	ruk' uq'alajilal
fluffy	k'o rismal
fluid	b'inel
fly	xik'ik'ik
focus	unik'ajal
focus	rilik
fog	muqulik sutz'
foggy	sutz'
fold	unutik
folks	taq achi'l
follow	uterne'xik
follow up	uterne'xik
following	jun chik
food	rikil
fool	ub'anik tzij
fool	pay
foolish	pay
foot	raqan
football	retz'ab'exik potz'
for	chech
For example	k'amb'ejab'al tzij
for instance	k'amb'ejab'al tzij
for you	chi awech
forbidden	man ya'om ta b'e che
force	chuq'ab'
forecast	uya'ik ub'ixik apanoq
forehead	chi uwach
foreign	rech jun chi tinamit
forest	k'ache'laj
forever	junelik
forget	usachik
forgive	ukuyik makaj
forgot	xinsacho
fork	ixk'eqwab'al
form	petik
form	petib'al
form	nojisab'al wuj
form	ub'antajik
form	unuk'maxik
formal	retal
former	jun kanoq
fortunately	we k'o ch'akanem
fortune	meb'a'il
forty	kawinaq
forty-two	kawinaq keb'
forward	chi uwach
foster	k'amik rij
fought	ch'a'oj
found	xinriqo
foundation	utikitajik
four	kajib'
fourteen	kajlajuj
fox	par
fragile	kq'ajik
frame	kajxukut
framework	framework
fraud	elaq'
freak	man qas ta kaya'tajik
free	sipatalik
freedom	tzoqopim
freeze	ut'ajajarisaxik
frequency	chi jantaq
frequent	amaq'el
frequently	amaq'el
fresh	k'ate ub'anik
friday	uro' q'ij
fridge	t'ajajarisab'al
friend	achi'l
friendly	kub'an achi'l
friends	taq achi'l
friendship	achi'l
frightened	uxib'im rib'
frightening	k'ax rilik
frog	ixtutz'
from	rech
front	chi uwach
frozen	t'ajajirisam
fruit	uwach che'
frustrated	uriqom k'ax
fuel	uja'al ch'ich'
Fulfulde	Fulfulde
full	nojinaq
fun	ki'kotem
function	uchak
fundamental	qas kachokonik
funeral	muqb'al
funny	tze'b'al
fur	wi'aj
furious	k'anarinaq
furniture	taq jastaq
further	nik'aj chik
furthermore	xuquje'
future	petinaq aq'anoq
gain	ch'akik
gain	riqonem
gain	uriqik
gain	ch'akoj
game	etz'anem
gap	q'a'am
garage	k'olib'al ch'ich'
garbage	mes
garden	chikopb'al
garlic	anxux
gate	uchija
gather	umulixik
gathering	umulixik chi jumul
gauge	retaxik
gave	b'ij
gear	wokaj
gender	ub'antajik
general	chi ronojel
generally	chi ronojel wi
generate	uwinaqirisaxik
generation	b'antajem
generous	sipanel
genius	k'o reta'mab'al
genre	b'antajik
gentle	tob'anel
genuine	qas tzij
gesture	memal
get	uriqik
get dressed	ukojik atz'yaq
get up	wa'lijem
get well soon	aninaq ta b'a' katkunatajik
getting	ktajin uriqik
ghost	xib'inel
ghosting	xib'inel wachib'al
giant	sib'alaj nim raqan
gift	sipanik
ginger	xenxi'p
girl	ali
girlfriend	k'ulajil
give	uya'ik
give up	k'olem kanoq
given	ya'om
glad	kki'kotik
glance	rilik
glass	b'as
glasses	ilwach
glimpse	rilik
global	chi ronojel
gloomy	kb'isonik
gloves	tasb'al q'ab'aj
glow	uq'alajilal
glow	q'apowik
glow	uq'apowil
glow	saqilal
glow up	rapq'inik
glue	nak'b'al
go	b'enam
go ahead	chi uwach
go away	jat
go to bed	q'oyolem
goal	opanib'al
goals	taq riqonem
goat	k'isik'
god	ajaw
god bless you	are ri ajawixel kattewechi'nik
goes	b'enam
going	b'enam
going to	b'anem pa
gold	q'an pwaq
gone	b'enam
gonna	b'enam pa
goo	k'axaj
good	ajloq'
good	sib'alaj je' ub'anik
good	utz
good	je'l upetik kaloq'onik
good	sib'alaj utz
good	utz ranima
good	utz una'oj
good afternoon	xb'e q'ij
good bye	jeb'a'
good day	utzalaj q'ij
good evening	xokaq'ab'
good job	utzalaj chak
good looking	kajunamatajik
good luck	utz ta b'a' xub'ano
good morning	saqirik
good morning my love	saqirik nuloq'ob'al
good night	xokaq'ab'
goodbye	jeb'a'
goodnight	xokaq'ab'
goods	jastaq
Google	Google
Google Translate	Q'axeb'al tzij rech Google
goose	yuq patax
gorgeous	je'lik
gossip	ajaltzijol
got	uriqik
got it	kinch'ob'o
government	ajpop
grab	uchapik
grade	tan
gradually	xa kapaqi'k
graduate	ch'akanem
grain	t'orota'q ija'
grant	uya'ik
granted	ya'om
grapes	taq ki't'ub'
grasp	rok'onem
grass	q'ayes
grateful	kmaltyoxinik
gratitude	tyoxinem
grave	jul kaminaq
gray	saqsoj
great	je'lik
greed	rayib'al k'u'xaj
greedy	xu'y
green	rax
greet	uya'ik utz petem
greeting	rutzil wachaj
greetings	rutzil wachaj
grey	q'eqq'oj
grid	kajxukut
grief	k'axk'ol
grind	uke'xik
grip	chapanem
grocery	k'ayib'al jastaq
groom	k'ulaj
gross	pay
ground	uwachulew
group	wokaj
grow	k'iyem
growth	k'iyem
grumpy	k'a'n
Guarani	Guarani
guarantee	uya'b'al q'alb'al k'u'xaj
guard	chajinel
guess	uch'akik
guest	sik'italik
guidance	k'utub'e
guide	k'amb'al cholajil
guide	k'amal b'e
guide	uk'amik b'e
guilty	are b'anowinaq
guy	b'antajik
guys	ak'alab'
gym	sak'alib'al
habit	naq'tisam ub'anik
habitat	achichib'al
had	xk'oji'
hail	saqb'ach
hair	wi'aj
half	nik'aj
hall	k'olib'al
hand	q'ab'
handle	uchakuxik
handsome	je'l upetik
hang	uxekeb'axik
hang out	elem b'ik
happen	ok'owem
happened	k'ulmatajinaq
happiness	ki'kotemal
happy	kikotem rech
happy birthday	uq'alajisaxik jun chi junab'
happy birthday to you	utzalaj uq'axexik alaxib'al chi awech
happy new year	ki'kotemal k'ak' junab'
hard	ko
hardly	k'ate'
hardly ever	xaq junelik
harm	k'ax
harm	etzelal
harm	ub'anik k'ax
harmful	kub'an k'ax
harmony	junamil
harsh	k'ax
harvest	wachinem
has	k'o
hate	tzel krilo
have	k'olik
have a good day	sib'alaj jun utzalaj q'ij chi awech
have a nice day	jun utzalaj q'ij chi awech
have breakfast	wa re nimaq'ab'
have fun	ki'kotemal
have you eaten	atijom awa
having	ruk' ruk'a'xik
hazard	k'axk'olil
haze	muqulik sutz'
he	are'
he has	are' k'o
he is	are'
head	jolom
headache	q'oxom jolomaj
heal	kunaxik
healing	kunanem
health	utzwachil
healthy	k'o utzwachil
hear	uta'ik
heard	ta'om
heart	anima
heat	oyowarik
heat	umeq'ik
heat	oyowal
heat	b'ukunik
heat	q'aq'
heat	b'ukuwem
heaven	chikaj
heavy	al
hectic	ya'om uq'ij
height	raqan
heir	ajecheb'anelab'
heist	elaq'
held	xinchapo
hell	q'aq'
Hello	Jacha'
hello dear	jacha' loq'alaj
hello how are you	jacha' utz awach
hello how are you doing	jacha' utz awach
helmet	tob'al jolomaj
help	tob'anik
helpful	tob'anem
hence	xa k'u cha'
her	rech
herd	jupuq chij
here	waral
heritage	na'tajsab'al
hesitate	mayowem
Hey	Jacha'
Hi	Jacha'
hi how are you	jacha' utz awach
Hi there	utz awach
hidden	owatalik
hide	rowaxik
hierarchy	eqelomal
high	nim raqan
highlight	ukojik retal
hike	b'inem
hiking	upaqalik
hilarious	tze'b'al ub'anik
hill	ixkanul
him	ri
hip	uwi' a'
hips	utza'm achaq
hire	uchokik
hiring	chokonem
his	rech
history	uxe'al
hit	ch'ayanik
Hmm	Mmm
hobby	q'axeb'al ramaj
hold	uchapik
hold on	reye'xik
hole	jul
holiday	q'ij rech uxlanem
hollow	jul
home	achoch
homework	chak
honest	b'anal suk'il
honestly	b'anal suk'il
Honey	ukab'il
Honey	loq'alaj
Honey	ukab' ajij
Honey	Kab'
honor	ya'b'al q'ij
hood	t'o'y
hook	tiqchapab'al
hop	xk'anik
hope	ch'ijk'il
hope	eye'nik
hope	ch'ijb'al
hope	q'alb'al k'u'x
hope	eye'b'al
hopefully	k'o uch'akanik
hopeless	man k'o ta eye'b'al
horizontal	q'e'lik
horn	ta'ob'al
horrible	xib'ib'al
horror	itzel sik'
horse	kej
hospital	ja kunanib'al
hospitality	k'o pa ja kunanib'al
host	ruk'axik
host	ajchoq'e
host	rech
host	wokonel
hostile	k'ulel
hot	k'atan
hotel	hotel
hour	ramaj
hours	taq ramaj
house	ja
household	raqan uq'ab' ri ajupaja
how	pacha'
how about you	jas uwach chi awij
how are you	utz awach
how are you doing	jas ab'anom
how are you doing today	jas ktajin kub'an we q'ij chi awach
how are you today	jas ab'anom kamik
how do you do	jas ab'anom
how is	jas ub'anik
how many	janik'pa'
how much	janik'pa'
how often	chi jantaq
how old are you	janik'pa' ajunab'
how was your day	jas xub'an ri aq'ij
how was your night	jas xub'an ri achaq'ab'il
however	xa k'ut
hub	waqwach
hubby	achajilom ixoqilom
hug	laq'apunem
hug	malalajenik
hug	laq'apunik
hug	malalajem
huge	sib'alaj nim
human	winaq
humble	k'o ta umak
humid	raxqinilik
humidity	raxal
hundred	jok'al
hungry	k'o unumik
hunt	tzukunem
hurricane	keb' raqan
hurry	aninaqil
hurry up	chakowij
hurt	ub'anik k'ax
husband	achajilom
hustle	ub'anik aninaqil
hut	alaj ja
hygiene	ch'ajch'ob'em
I	In
I am	In
I am fine	Utz nub'anom
I can	Kinkowinik
I can't	Man kinkowin taj
I do	In kinb'ano
I do not know	Man weta'm taj
I do not understand	Man kinch'ob' taj
I don't	Man in taj
I don't know	Man weta'm taj
I don't understand	Man kinch'ob' taj
I don't understand what you mean	Man kinch'ob' taj jas kawaj kab'ij
I don't understand you	Man katinch'ob' taj
I don’t know	Weta'm taj
I don’t understand	Man kinch'ob' taj
i guess	qab'ana che
I had	Xk'oji'
I have	K'o
I have been	Ink'olinaq
I hope so	Are kinweye'j
I know	Weta'am
I like	Utz kinwilo
I like you	Utz katwilo
I love	Kwaj
I love my big brother	Kinloq'oj ri watz
I love my big sister	Kinloq'oj ri wanab' nab'e'al
I love my father	Kinloq'oj ri nutat
I love my little brother	Kinloq'oj ri alaj nuchaq'
I love my little sister	Kinloq'oj ri wanab'
I love my mother	Kinloq'oj ri nunan
I love you	Katin loq'oj
I love you so much	Sib'alaj katwaj
I love you too	Xuquje' in katwaj
I mean	Kwaj kinb'ij
I miss you	Katinb'isoj
I miss you so much	Sib'alaj katinb'isoj
I see	Kinwilo
I think	Kinchomaj
I understand	Kinch'ob'o
I want	Kwaj
I want to see you	Kwaj katinwilo
I want you	Katwaj
I was	Xinb'e
I will	Kinb'e pa
I would be	Pa uchuq'ab'il
I'm	In
I'm fine	Utz nub'anom
I'm good	utz nub'anom
I'm here	In k'o waral
I'm sorry	Kuyu'
ice	kaxlan tew
ice cream	t'ajtij
idea	no'j
ideal	qas utz
identical	junam
identify	rilik
identity	k'utwinaqil
idiot	pay
idle	jamal uwach
if	we
ignore	uya'ik kanoq
ill	yowab'
illegal	man ya'om ta b'e chech rumal q'atb'altzij
illness	yab'il
Ilocano	Ilocano
image	wachib'al
imagine	uchomaxik aq'anoq
immediate	aninaqil
immediately	aninaqil
immense	sib'alaj nim
impact	ropanik
impatient	man k'o ta koch'onik
implement	uya'ik
import	rilik
import	rilik apanoq
import	jek'ik
import	jek'onem
important	sib'alaj rajawaxik
impose	uya'ik
impossible	k'ax ub'anik
impress	uya'ik uq'ij
impression	nab'anem
impressive	sib'alaj je'lik
improve	ub'anik utz che
improvement	ub'anik rutzil
in	pa
in addition	xuquje'
In fact	Rech b'anoj
in front of	chi uwach rech
in order to	chech
inappropriate	man utz ta ub'ixik
incentive	tojb'al
incident	k'axk'ol
include	uya'ik
including	chi'l
income	okem
inconvenience	k'axk'olil
increase	unimarisaxik
increase	upaqab'axik
increase	uk'iyik
increased	ktajin uya'ik
incredible	maj jewi
indeed	xa k'u jewa'
independent	man k'o ta chi'l
India	India
indicate	uya'ik ub'ixik
indigenous	mayab' winaq
individual	chi jujunal
industry	k'aywokaj
inevitable	man kq'at taj
infant	rech k'iysanik
infection	chomarem
infinity	man k'o ta rajilb'alil
inflammation	chomarisanem
inflation	chomarem
influence	yakanik
influence	uk'amik b'e
influence	k'amol b'e
influence	kyakow rech
inform	q'alajisanem
information	q'alajisanem
ingredients	ri kaya ruk'
inheritance	echeb'al
initial	majib'al
initiative	utikitajik
injured	uriqom k'ax
injury	sokotajem
innocent	man k'o ta kub'ano
innovation	k'exonem
inquiry	ta'onem
insane	pay
insect	chaqi'j chikop
insecure	man qas ta je k'olik
insert	uch'apik
inside	chi upam
insight	eta'manik
insist	uta'ik na
insomnia	waramil
inspiration	karaj kub'ano
inspire	woktzijonem
install	ujeqeb'axik
instance	jun q'ij
instant	aninaqil
instead	chi uwach
instead of	chi uwach ri
instructions	taqanem
instrument	chakub'al
insult	yoq'onem
insurance	qas utz
intact	man k'ota b'anom che
integrity	wokowinaq
intellectual	k'o reta'mab'al
intelligence	k'o eta'manem
intelligent	k'o reta'mab'al
intend	k'o uchomanik che
intended	kraj kub'ano
intense	k'o uchuq'ab'
intention	karaj
interact	uriqik ib'
interaction	tzijonem
interest	kraj
interested	karaj kub'ano
interesting	sib'alaj k'o kchokon wi
interfere	uminik ib'
intermediate	uxo'l
internal	k'olotalik
international	q'axamaq'
internship	k'olom
interpret	uq'axexik
interpreter	aj q'axel tzij
interrupt	uq'atik
interview	uta'ik tzijonem
into	pa
introduce	okik
introduction	okib'al
introvert	maj kraj kub'ano
intuition	na'b'anem
invalid	man utz taj
invent	uwokik aq'anoq
inventory	ajilan meb'a'il
invest	ujalk'atixik
investigate	usolik uxe'
invitation	sik'inem
invite	sik'inik
invoice	uwujil tojonik
invoice	uya'ik uwujil q'atoj tojonem
invoice	uya'ik uwujil tojonik
invoice	uwujil loq'oj
involve	k'olem
involved	k'olem chi upam
iron	usuk'maxik atz'yaq
iron	suk'mal atz'yaq
is	kaxlan tzij
island	rumal ja'
isolated	tasom
issue	uya'ik
issue	ucholajixik
issue	reta'maxik
issue	ujab'uxik
issue	uq'alajisaxik
issue	ucholajil
issues	taq jastaq
it	le
it is	are
it was	xb'e
it's	are'
it's ok	utz la'
It's okay	utz la'
item	jastaq
items	taq jastaq
its	rech
I’m	In
jacket	xyal
jail	pa che'
January	nab'e ik'
jar	k'olib'al
jaw	uxe' chi'aj
jealous	achixom
jerk	pay
jewelry	k'ayib'al etz'eb'alil
job	chak
jogging	tijow anim
join	utz'ib'axik ib'
joint	wokaj
joke	etz'anem tzij
journalist	ya'l ub'ixik
journey	b'yajem
joy	ki'kotemal
judge	uq'atzik tzij
judge	q'atal tzij
juice	uwa'l
july	uwuq ik'
jump	pixk'anem
june	uwaq ik'
junk	mes
just	chi jutz'it
just	xew wi
just	tz'aqat
just	suk'
just do it	xew chab'ana'
justice	q'atoj tzij
justify	usuk'maxik
K'iche'	K'iche'
Kalaallisut	Kalaallisut
keen	kojom
keep	ruk'axik
keep it up	chab'ana jela'
kept	tzuqum
kettle	k'olib'al saqli'
key	lawe
kick	ukojik aqan
kid	ak'al
kidding	katajin kb'an etz'anem tzij
kidney	kinaq'
kids	ak'alab'
kill	kamisanik
kind	kaloq'oxik
kind	b'antajem
kind	ub'antajik
kind	kach'ach'atik
kind	ch'ach'atem
kind	loq'onem
kinda	jub'eq'
kindly	ruk' loq'ob'al
kindness	ch'ach'atem
king	ajawinel
kiss	tz'umanem
kitchen	b'anb'al wa
kite	juch'ch'umil
kitten	alaj me's
knee	ch'ekaj
knew	xinweta'maj
knife	pusb'al
knight	achija'il
know	reta'maxik
knowledge	reta'maxik
known	eta'matalik
Konkani	Konkani
Krio	Krio
label	ukojik retal
label	etal
label	retwokaj
labor	uk'olik ak'al
labour	chak
lack	kraj na
ladder	aq'anib'al
lady	ixoq
laid	uya'ik
lake	cho
lamb	karne'l
lame	ch'oko'y
lamp	ya'b'al q'aq'
land	ulew
land	uwchulew
land	qajem
landscape	rilb'al chi ronojel
language	ch'ab'al
lap	ja'nem
large	raqan
last	uk'isb'al
last but not least	chi uk'isb'al xa k'u man qas ta rajawaxik
last name	ukab' b'i'aj
late	matam
lately	chi uk'isb'al
later	sib'alaj matam
latest	ri uk'isb'al
latter	ri uk'isb'al
laugh	tze'nem
laughing	tze'nem
laughter	tze'tzotem
launch	wa rech paq'ij
laundry	tz'il atz'yaq
law	taqanik
lawn	uwasaq
lawyer	tob'anel
lay	uya'ik
layer	lik'q'u'b'al
layout	lya'nik
lazy	q'or
lead	uk'amik b'e
leader	k'amal b'e
leaf	uxaq
leak	tz'uj
lean	pachalem
leap	xk'anem
learn	reta'maxik
learning	eta'manem
lease	uqajik ja
least	chaq'ixel
leather	tz'u'um
leave	uya'ik kanoq
leave	uya'ik b'e
leave	ya'ik kanoq
leave	relesaxik
leave	ya'ik b'e
leaves	uxaq wuj
led	xinb'insaj
left	moxq'ab'
leg	a'
legacy	ya'om kanoq
legal	qas ya'om b'e chech
legend	k'ulmatajem
legit	qas are'
leisure	uxlanem
lend	uqajik
length	nim
less	k'i taj
lesson	eta'manem
let	uya'ik kanoq
letter	tz'ib'wuj
lettuce	rax ichaj
level	lik'alik
leverage	upek'ik
liability	rajawaxik kb'anik
library	k'olwuj
lick	req'ik
lie	ub'anik tzij
lies	ub'anik tzij
life	k'aslemal
lift	paqab'saxik
lift	paqalib'al
lift	wa'lijisanem
lift	paqab'sanem
lift	rajililal
lift	uwa'lijisaxik
light	uchupik
light	utzijik
light	q'alaj
light	wachinem
light	kaxlan q'aq'
lightning	xkoyopa'
like	pacha'
likely	wene
likewise	xa k'u jewa'
line	juch'
Lingala	Lingala
link	t'iqb'al
lion	koj
liquid	ja' uwach
list	cholajil
listen	uta'ik
listening	ta'onem
literally	pacha' ya'om ub'ixik
literature	tz'ib'
litter	mes
little	nitz'
live	k'olik
live	kamik
live	k'aslem
live	k'amik'
live	k'aslik
live	K'olem
liver	pospo'y
lives	taq k'aslemal
living	k'olem
living room	k'olib'al
lizard	ixpa'ch
load	uya'ik
loaf	muchunem
loan	qajanem
local	ajwaralik
location	k'olib'al
lock	utz'apixik
lockdown	utasik
log	kuta'm
lol	jajaja
lonely	tukelal
long	raqan
long time no see	sib'alaj naj chik wilom awach
look	petik
look	rilik
look	petib'al
look	ilonem
look	junamatajik
look	junamatajem
loop	bucle
loose	tzoqopim
loose	tukelam
loose	tukelanik
loose	ukorob'axik
loose	tzoqopinik
loose	koronik
lord	tat
lose	utzaqik
loss	tzaqem
lost	sachinaq
lot	jub'a'
loud	k'o uchuq'ab'
lounge	k'olib'al
love	utz kinwilo
love	loq'onik
love	loq'ob'al
love	ajawanem
love	ajawanik
love	utz rilik
love you	ktinloq'oj
lovely	utz
low	maj uchuq'ab'
lower	uqajik
loyal	suk'
loyalty	suk'il
luck	ch'akanem
lucky	ch'akanem
Luganda	Luganda
luggage	k'olib'al jastaq
lump	eqa'n
lunch	wa rech paq'ij
lungs	pospo'y
luxury	k'iyarempatan
lying	ktajin kub'an tzij
machine	chakub'al
mad	royowal
madam	nan
made	b'anom
magazine	wachtz'ib'wuj
magnificent	qas je'lik
maid	taqo'n
main	qas nab'e
maintain	uk'olik
maintenance	ujosq'ixik
Maithili	Maithili
major	rajawaxik
major	ajsaqwachom
major	k'o uch'a'ik
major	nim
major	qas kajwatajik
majority	uk'iyal
make	ub'anik
make up	uya'ik uk'axel
male	achi
mall	uk'u'x k'ayib'al
man	achi
manage	uk'amik b'e
management	achochib'al
manager	kemchajinel
mandatory	qas rajawaxik wi
manifest	ub'ixik
manipulate	ukojik
manner	b'antajik
manual	tijon wuj
many	k'i
many many happy returns of the day	ktz'aqatisaj ta b'a' k'i junab' na
march	b'inem
margin	uchi'
market	k'ayib'al
marriage	meb'a'il
married	k'ulanik
mask	k'oj
mass	ch'ab'al
massive	k'o uchuq'ab'
master	ajchoq'e
match	ujunamaxik
match	tzijb'al q'aq'
mate	achi'l
material	chakub'al
math	taq ajilanb'al
matter	uchomaxik
matter	ucholajixik
matter	uk'amik loq
matter	jastaq
matter	ucholajil
maturity	nimarem
may	wene
may	uxlanem
may	mayo
may	wokinem
may	la
maybe	pine'
me	kin-
me too	in xuquje'
meal	rikil
mean	q'alajisanem
mean	retal
mean	itzel
mean	etalil
mean	uq'alajisaxik
mean	pa nik'aj
mean	nik'aj
meaning	kel kub'ij
means	unik'ajal
meant	xwaj xinb'ij
meanwhile	are tzij
measure	retaxik
measures	etb'alil
meat	ti'ij
medical	ajkun
medicine	kunab'al
meditation	uchomaxik
medium	nik'aj
meet	uch'ob'ik uwach
meeting	riqoj ib'
Meiteilon	Meiteilon
melt	ja'rik
memories	taq k'oxomab'al
memory	k'oxomab'al
mental	pa chomanik
mention	uya'ik ub'ixik
mentioned	ya'om ub'ixik
mentor	ajno'jinel
merchant	ajk'ay
mercy	tow toq'ob'
merry christmas	alaxb'al
mess	nimalaj k'ax
message	oqxa'n
messy	man cholajim taj
metal	ch'ich'
method	k'amb'alcholajil
mice	e ch'o
middle	nik'aj
midnight	nik'aj aq'ab'
might	wene
mild	ch'uch'uj
milestone	etal
military	chajinel
milk	uwa'l tu'
million	wuqlk'ala'
mind	ilawachinem
mind	k'oxomanem
mind	uk'ami loq
mind	ilawachinik
mind	chomanem
mind	k'oxomanik
mind	chomanik
mindset	k'oxomab'al
mine	wech
mine	etab'al
mine	ech
mingle	kajunamatajik
minor	maja ujunab'
minute	kajb'al
minutes	taq kajb'al
miracle	mayib'al
mirror	ilb'al ib'
miscellaneous	jaljoj uwach
mischievous	k'ax uch'ab'exik
miserable	meb'a'
misery	meb'a'
miss	b'isonik
miss you	katinmayo
missing	sachinaq
mission	misión
mist	sutz'
mistake	sachem
Mizo	Mizo
mobile	achib'il ch'aweb'al
mock	ub'ixik tzij
model	k'utunem
moderate	b'anom q'atenem che
moderate	q'atenem
moderate	uq'atik
modern	k'ak'arisam
modest	meb'a'
moist	raxqinilik
moisture	raxqinilik
mold	pus
mold	b'anik
mold	b'anb'al
mold	raxqi'n
mole	rikil
mom	nan
moment	q'ij ri'
monday	nab'e q'ij
money	pwaq
monitor	k'utwachib'al
monkey	k'oy
month	ik'
mood	tze'b'alil
moody	man k'o ta karaj
moon	ik'
moral	Utzik'u'x
more	nik'aj chik
moreover	xuquje'
morning	aq'ab'il
mortgage	uqajik pwaq chi uwach ri ja
most	ri uk'iyal
mostly	pa uk'iyal
mother	nan
motion	silob'em
motivation	paqchib'al rech
mountain	juyub'
mouse	ch'o
mouth	chi'aj
move	silab'em
movement	silob'em
movie	k'utwachinem
mrs	nan
much	k'i
mud	xaq'o'l
mug	alaj xa'r
muscle	tyo'jilal
museum	k'olib'al ojer jastaq
mushroom	ikox
music	q'ojom
must	rajawaxik kb'anik
must	rajawaxik
must	kb'anik
must	qas are wi
mute	mem
mutual	junamil
my	un
My dear	Nuloq'aj
my friend	wachi'l
My hovercraft is full of eels	Ri nujililb'al nojinaq chech chikop
my love	nuloq'ob'al
my name is	ri nub'i' are'
my pleasure	k'o ta kub'ano
myself	in wi
mysterious	kajamb'al
mystery	kajamb'al
myth	xk'ulmatajem
nail	ixk'aq
naive	aj no'j
name	b'i'aj
narrative	uya'ik ub'ixik apanoq
narrow	nitz' uwach
nasty	tzel una'ik
national	tinamitalil
nationality	tinamitalil
native	qas alaxinaq wi
natural	natural
nature	qanan ulew
nausea	xa'oj
near	naqaj
nearby	naqaj
nearly	jutz'it chik
neat	sib'alaj utz
necessary	rajawaxik
neck	qulaj
necklace	chachal
need	kraj na
need	rajawaxik
need	ch'a'ik
need	uch'a'ik
negative	maj
neglect	uya'ik kanoq
negotiate	uqasaxik rajilal
neighbor	k'ulja
neighborhood	k'ulja
neither	man chi'l ta
nephew	ch'utik'ajol
nerd	nerd
nervous	kuxe'j rib'
nest	soktz'ikin
net	k'olik
network	kemk'at
neutral	man k'o ta ub'e'al
never	junelik
never give up	man kaya ta wi kanoq
never mind	sachom kanoq
nevermind	sacha kan chla'
nevertheless	xa k'u cha'
new	k'ak'
news	taq xajtajem
next	jun chik
next to	chi utzalaj rech
nice	je'lik
nice to meet you	ki'kotemal reta'maxik awach
niece	ch'utik'ajol
night	chaq'ab'
nightmare	itzel wachik'
nine	b'elejeb'
nineteen	b'elejlajuj
ninety	jumuch' lajuj
No	Ja'i'
no problem	man k'o ta k'eyowal
no way	man jumul ta wi
nobody	maj
noise	wululem
noisy	kawululik
none	maj
noon	unik'ajal q'ij
nope	ja'i'
nor	man chi'l ta
normal	retal
north	releb'al kaqiq'
nose	tza'maj
nostalgic	q'ututem
not	ja'i'
not at all	maj wi
not bad	man qas ta are' che k'ax
Not now	Chanim ja'i'
not yet	maja na
note	ub'ixikil
noted	tz'ib'am
nothing	maj
notice	uya'ik ub'ixik
noticed	xinwilo
noun	b'i'aj
nouns	b'i'aj
novel	nob'el
november	ujulaj ik'
now	chanim
nowadays	kamik q'ij
nuisance	k'axk'ol
null	man k'o ta kub'ano
numb	q'oxowem
number	ajilab'al
nurse	chajinel yawab'
nut	nuez
nutmeg	kok'amani'y
nutrition	tzuqunem
oath	suk'matajem
obesity	chomarem
obey	unimaxik
object	jastaq
objective	ajawatajem
obligation	rajawaxik kb'anik
obscure	qequ'm
observation	ilonem
observe	rilik
obsessed	mayowem
obsession	mayowem
obsolete	k'isnaq uq'ijol
obstacle	q'ateb'al
obtain	uriqik
obtained	xinriqo
obvious	je wi
obviously	qas jewi
occasionally	chub'anik
occupation	uchak
occupied	man tolon ta uwach
occur	k'ulmatajik
occurred	k'ulmatajinaq
occurs	kk'ulmatajik
ocean	saqpolo
october	ulaj ik'
odd	jun wi
odds	junwi
of	rech
of course	jewi
off	chupum
offensive	k'ax tzij
offer	utzujuxik
offer	qasam rajilal
offer	uqasaxik rajilal
offer	tzujunem
office	ja chakub'al
official	kojom
often	amaq'el
Oh	Oh
oh really	ah che tzij
oil	qepowja'
ok	utz
ok dear	utza loq'alaj
ok honey	utz la' loq'olaj
ok my love	utz la' nuloq'ob'al
okay	utz
okay baby	utz la' ne'
okay dear	utz la' loq'alaj
okay honey	utz la' loq'alaj
okay my love	utza' nuloq'ob'al
old	ri'j
on	pa
once	jumul
one	jun
one language is never enough	jun ch'ab'al man kub'ana taj
onion	sipoyix
online	pa nimk'atz
only	xew
open	jaqom
operation	uchakuxik
opinion	utzijolil rij
opportunities	jalajoj taq uya'ik
opportunity	ya'tajem
opposite	jalan wi
optimistic	kki'kotik
option	jalajoj ucha'ik
optional	jalajoj ucha'ik
or	on
orange	tz'ajb'al q'anq'oj
orange	alanxax
orange	kaqkoj
order	ucholajixik
order	ta'ik
order	cholajinik
order	ta'onem
order	taqanik
order	taqanem
order	cholajinem
ordinary	amaq'el
organization	wokaj
orientation	no'jinem
origin	uxe'al
original	qas are'
Oromo	Oromo
orphan	minor
other	jun chik
otherwise	jun chi ub'antajik
ought	rajawaxik
our	qa
Our mission: to enable everyone, everywhere to understand the world and express themselves across languages.	Ri qachak: Uya'ik b'e chi kech konojel, pa ronojel tinamit, kaketa'maj ri uwachulew xuquje' ri tzijonem pa ronojel taq ri ch'ab'al.
Our mission: to organize the world's information and make it universally accessible and useful.	Ri qachak: unuk'maxik ri q'alajisanem rech ronojel uwachulew xuquje' are che utz kab'an okem chi upam xuquje' qas kchokonik.
out	elem b'ik
outcome	uwachinem
outfit	jastaq
outgoing	elem b'ik
outlet	esab'al kaxlan q'aq'
outline	chi rij
outside	chi rij
outstanding	qas kch'akanik
oven	miq'sab'al
over	chi rij
over there	chi waral
overall	pa uwi' ronojel
overcome	uxalq'atixik
overthinking	k'i uchomaxik
overwhelmed	b'isonem
overwhelming	kosib'al
owe	rajawaxik
owl	tukur
own	k'olik
own	ajchoq'e
own	rech
owner	ajchoq'e
ox	juk'ulaj wakax
pace	ok'owib'al
pack	tanaj
package	tanaj
paid	xintojo
pain	q'oxom
paint	tz'ajanik
painting	tz'ajb'al
pair	uk'ulaj
pale	saqtub'
palm	upa q'ab'aj
pan	q'anarisab'al
pandemic	nimalaj yab'il
pants	saka'w
paper	uxaq wuj
paradise	para'is
parallel	junamil
parcel	oqxa'n
pardon	kuyu'
parents	tat nan
park	uxlanib'al
parrot	lo'r
parsley	kawachkulanto
part	utz'aqatil
participate	k'olem
particular	tukelal
partner	k'ulajil
party	nimaq'ij
pass	uq'axexik
passage	b'e
passed	xinok'owik
passion	qas kab'anik
passionate	qas karaj kub'ano
passive	relik rajilal b'ik
password	retokib'al
past	q'axnaq kanoq
patch	k'ojob'al
path	b'e
pathetic	qas q'an che
patience	k'o uch'ijb'al
patient	k'o uch'ijb'al
patient	koch'kil
pattern	ajchaq'e chak
pause	uq'atab'axik
pavement	b'e b'anom ruk' ixim ab'aj
pay	utojik
payment	tojonik
peace	jamaril
peaceful	k'o reyeb'al
peach	q'antura's
peak	uwi'
pear	raxtzu
peas	alb'erxex
peculiar	b'antajik
pee	chulunik
pee	chulunem
peel	uch'olik
peer	k'ulaj
peers	junam
pen	tz'ib'ab'al
pencil	che' tz'ib'ab'al
pending	yamalik
people	e winaq
pepper	pimienta
perceive	uya'ik ub'ixik
perception	chomanem
perfect	suk'
perform	uchak upatan
performance	nim uchak upatan
perhaps	wene
period	uq'ijol
permanent	junelik
permission	uya'ik b'e
permit	uya'ik b'e
perseverance	koch'onem
persistent	k'o ukoch'onik
person	winaq
personal	ajchakib'
personality	uwinaqil
perspective	ub'antajik
persuade	uk'amik b'e
pervert	maj uk'ix
pet	maskot
phase	cholajil
phenomenon	k'exonem
philosophy	chomanem
phone	ch'aweb'al
photo	wachib'al
phrase	nitz' chomanik
physical	petib'al
pick	usik'ik
pick up	usik'ik
picture	wachib'al
piece	utz'aqat
pieces	utz'aqat
pig	aq
pigeon	palomax
pile	unutik
pillow	ch'akataj
pilot	b'insal ch'ich'
pin	b'aq
pineapple	ch'op
pink	kaqkoj
pit	jul
pitch	uqajb'al
pity	k'eyowal
place	utinamitalil
place	k'olib'al
place	achochib'al
place	tinamit
places	taq k'olib'al
plague	plaga
plain	li'anik
plan	q'ayes
plane	xik'ich'ich'
plant	q'ayes
plants	taq q'ayes
plate	wab'al
platform	t'uyulb'al
play	etz'anem
play	chapanik
play	retz'ab'exik
play	etz'anik
play	uchakuxik
play	chakuxik
play	chak
playing	etz'anem
pleasant	sib'alaj je'lik
please	usachik makaj
please	sacha numak
please	chab'ana jun toq'ob'
please	jun toq'ob'anik
please	kuyu'
please	kaqajik
please	k'uyunik
pleased	utz rilom
pleasure	b'anoj
pledge	uchi'xik
plenty	maj uk'isik
plot	nuk'maxik
plug	ut'iqik
plum	k'uxk'ab'el
plumber	jeqol joron
plural	k'iyal
podcast	podcast
poem	nab'alil
poetry	nab'alil
point	nak'
poison	itzel kunab'al
police	ajchajil tinamit
policy	taqanik
polite	kch'ach'atik
pollution	kuya yab'il
pond	muxanb'al
pool	muxanib'al
poop	kis
poor	meb'a'
pop	paq'inik
popular	k'o uch'a'ik
population	winaqib'
pork	aq
porridge	mox
port	okib'al
position	k'olib'al
positive	qas are'
possess	k'o
possession	k'olib'al
possessive	ajch'uqelal
possible	kb'anik
post	taqoqxa'nib'al pa kematz'ib'
post	ujab'uxik
postpone	uya'ik kan pa jun q'ij chik
potato	saqwach
potential	uchuq'ab'il
pound	libra
poverty	meb'a'
power	uchuq'ab'il
powerful	k'o uchuq'ab'
practical	qas kb'anik
practice	naq'tisam ub'anik
practice	ub'anik
practice	reta'maxik
practice	b'anoj
praise	uya'ik q'ij
prank	etz'anem tzij
pray	ub'ixik ch'ab'al
precious	je'lik
precise	qas are'
precisely	qas are wi
predict	uya'ik ub'ixik apanoq
prefer	are kraj
preference	ajawatajem
pregnant	yowab' ixoq
prejudice	mayowem
premises	taq k'olib'al
premium	are qas nab'e
preparation	unuk'maxik
prepare	ub'anik
prepared	k'o chik
preposition	nab'e k'olik
presence	k'olem
present	k'olem
present	tyoxinem
present	sipanem
presentation	k'utunsanem
preserve	uk'olik kanoq
president	k'amal b'e rech amaq'
press	wuj q'alajisab'al
press	pitz'onem
press	upitz'ik
pressure	uchuq'ab'il
pretend	ujaluxik
pretty	je'lik
pretty	utz upetik
pretty	je'lalaj
pretty	utz
pretty	k'iyarem
prevent	uq'atik uwach
previous	mojo'qa che
prey	chapanem
price	rajilal
pride	nimal
priest	pare
primary	nab'e
prime	sib'alaj je'lik
princess	ixq'alel
principal	k'amal b'e
prior	jun kanoq
priority	rilik ub'anik
prison	che'
privacy	echeb'alil
private	rech tukelal
privilege	eqele'n
prize	ch'akanem
probably	wene
problem	k'eyowal
procedure	b'anoj
proceed	ub'anik
process	ucholajixik
process	ukojik wuj pa q'atb'altzij
process	q'axnem
process	uq'axexik
process	cholajil
produce	ub'anik
product	k'ayij
production	ub'anik
profession	riqtijonem
professional	ajsaqwachom
profile	cholk'aslemal
profit	ch'akoj
profound	nim qajinaq
progress	q'axnik
progress	yakatajem
progress	katajik
progress	uwa'lijisaxik uwach
progress	q'axnem
project	cholchak
promise	chi'xik
promise	chi'nem
promise	uya'ik q'alb'al k'u'xaj
promise	uchi'xik
promote	uya'ik
promotion	paqalinem
prompt	aninaq
prone	jupulem
pronouns	uk'exwach b'i'aj
pronunciation	jas ub'ixik
proof	k'amb'ejanem
proper	b'anom rech chech
properly	qas utz ub'anik
properties	ub'antajik
property	ub'antajik
proposal	kaya ub'ixik
prospect	jalajoj ub'ixik
prosperity	tewechib'al
prosperous	k'o umeb'a'il
protect	uchajixik
proud	nimal
prove	retaxik
provide	uya'ik
provided	xinya'o
province	alaj tinamit
provision	patanib'al
puberty	k'ajolal
public	kech uk'iyal
pull	ujek'ik
pumpkin	tz'etz'
punctual	atam ke'opanik
pupil	tijoxel
purchase	loq'oj
pure	qas tzij
purple	raxpopoj
purpose	ajawatajem
purse	k'olib'al jastaq
pursue	uterne'xik
pursuit	uterne'xik
push	upaqchixik
put	uya'ik
qualification	k'o uwujil
quality	uq'alajilal
quantity	uk'iyal
quarantine	tastajem
quarrel	ch'o'jinem
quarrel	ch'ojinik
quarrel	ta'onem
quarter	ukaj utz'aqat
Quechua	Quechua
queen	rajawal ixoq
queer	jun wi
query	esab'al ab'aj
question	k'otow chi'aj
queue	cholajinik
queue	k'isb'alil
queue	ucholajixik ib'
queue	cholaj
queue	je'
quick	aninaq
quickly	aninaqil
quiet	matzalik
quilt	q'u'aj
quit	relesaxik
quite	relesaxik
quite	chi ronojel
quite	qas je wi
quite	sib'alaj k'i
quiz	k'amb'ejanem
quotation	sik'inem
quote	sik'ixik
quote	sik'inem
quotes	taq sik'inem
rabbit	imul
race	upetib'al
rage	k'anal
rain	jab'
raise	nimarisanik
raise	nimarisanem
raise	paqab'anem
raise	xib'inik
raise	upaqab'axik
raised	kk'iysaxik
ran	xinanimajik
random	xaq k'ate'
range	eqelomal
rapid	aninaq
rapidly	aninaqil
rare	jun wi
rarely	jun wi
rash	puluw xkanul
rat	b'ayi's
rate	rajilal
rather	are kjawataj
ratio	uqajb'al
rational	suk'
raw	rax
re	jastaq
reach	uch'akik
reached	unimal
reaction	uk'ulaxik uwach
read	usik'ixik uwach
reading	usik'ixik uwach
ready	utz chik
real	qas tzij
reality	qas ub'e'el
realize	kya kwent che
realized	ch'ob'om
really	qas tzij
rear	chi rij
reason	ub'antajik
reasonable	utz uchomaxik
recall	una'tajisaxik
receipt	uwujil tojonik
receive	uk'amik
received	xink'amo
recent	maja naj
recently	maja naj
reception	uk'amik
recipe	cholajil saqil
reckless	man kk'oxoman taj
recognition	uch'ob'ik uwach
recognize	uch'ob'ik uwach
recommend	uq'xa'nitalik
recommended	uqxa'nitalik
record	okem
record	uk'olik
record	k'olonem
record	k'olinik
record	utz'ib'axik
record	okik
recover	uriqik chi jumul
recovery	uriqik chi jumul
rectangle	nim kajxukut
red	kaq
redeem	uchupik
redemption	kolotajem
reduce	unitz'arisaxik
redundant	kamulim
refer	utaqik b'ik
reference	usaqil tzij
reflect	kutunem
reflection	uwachinem
refrain	uq'atik ib'
refrigerator	t'ajajarisab'al
refund	utzalijisaxik
refuse	kamul ukojik
refused	kamul ukojik
regard	uchomaxik rij
regarding	are tzij ri
regardless	man are ta kub'ij che
regards	rutzil wachaj
region	rulewal tinamit
register	utz'ib'axik
regret	umayik
regular	ub'anik utz che
regularly	jewi
reject	retzelaxik
relate	ujunamaxik
related	kajunamatajik
relationship	ub'antajik
relative	kajunamatajik
relative	k'amarem
relative	alaxik
relative	junamatajem
relatives	achalaxik
relax	uxlanem
release	jab'unem
release	ujab'uxik
release	uya'ik b'e
release	tzoqopixik
release	tzoqopinem
released	ya'om b'e chech
relevant	k'o uch'a'ik
reliable	q'alb'al k'u'xaj
relief	jororem
relieve	uqasaxik
relieved	uxlanaq
religion	kojb'al
religious	kojb'al
reluctant	man knimaj taj
rely	q'alb'al k'u'x
remain	k'olem
remaining	uwi'
remarkable	kq'alajinik
remedy	ukunab'alil
remember	una'tajisaxik
remind	una'tajisaxik
reminder	una'tajisaxik
remote	najtajisam
remove	relesaxik
render	uya'ik kanoq
rent	qajik
repair	ujeqik
repeat	ukamulixik
replace	ujalik
reply	uk'ulaxik uwach
reply	utzalijisaxik uwach
report	q'alajisanem
report	uq'alajisaxik
report	uya'ik ub'ixik
represent	uk'utunsaxik
reputation	uwinaqilal
request	ta'om
request	utz'onik
request	uriqom k'ax
request	k'ayinik
request	k'ayij
require	kajawatajik
required	xintz'ono
rescue	kolonem
research	usolik uxe'
resemble	k'utunsanem
resentment	k'ax pa anima
reservation	ukolik apanoq
reserve	uk'olik kanoq
resident	aj waralik
resign	uya'ik kan jun chak
resilient	ajch'akanel
resist	uch'ijik
resistance	ch'ijkil
resolution	usolik uwach
resolve	usolik uwach
resort	pataninem
resources	pataninem
respect	k'ixb'anik
respect	k'ixb'alil
respect	ita'ik toq'ob'
respect	unimaxik
respond	uk'ulaxik uwach
response	uk'ulaxik uwach
responsibility	q'alb'al k'u'x
responsible	are ka'ilowik
rest	uxlanik
rest in peace	jamaril uxlanem
restaurant	tijb'al wa
restore	ub'anik utz che
restrict	uq'atexik
result	wachinem
results	taq uwachinem
resume	uch'utinirisaxik
retail	k'ayij man chi kech uk'iyal taj
retain	uq'atik
retention	uq'atexik
retired	man kchakun ta chik
retreat	elenaq chik
retrieve	uriqik chi jumul
return	tzalijem
reveal	uq'alajisaxik
revealed	q'alajisam
revenge	utzalixik uk'axel
revenue	q'atoj tojonik
reverse	chi rij
review	nik'oxik
review	unik'oxik
review	q'atuxik
review	uq'atuxik
review	rilik chi jumul
revise	uq'atuxik
revision	uq'atuxik
revolution	k'exonem
reward	uwachinem ch'akoj
rhythm	junab'inb'al
rib	k'alk'a'x
rice	aros
rich	q'inom
rid	relesaxik
ride	b'insanik
ride	k'amanem
ride	uk'amik b'e
ride	k'amanik
ride	paqi'k
ride	ub'insaxik ch'ich'
ridiculous	utz ta rilik
right	wikiq'ab'
right	suk'il
right	utz
right	suk'
right now	chanim
rigid	ko
ring	mulq'ab'
rinse	umub'axik
riot	ub'anik k'ax
rip	jisonem
rip	ujisik
ripe	ko
rise	paqalik
rise	nimarisanem
rise	paqalem
rise	nimarisanik
risk	k'axk'olil
risk	k'eyowal
risk	ub'anik wi
rival	k'ulel
river	nima'
road	b'e
roast	uk'ilixik
robust	kowilaj
rock	nim ab'aj
rod	b'ara
role	wuj
roll	usutixik
roof	uwi ja
room	achoch
root	ra'
rope	kolob'
rotten	q'ayinaq
rough	q'irinik
roughly	ruk' ch'a'ojimarem
round	ketekik
route	b'e
routine	amaq'el
row	cholaj
rub	b'och'onem
rubber	ul
rubbish	ik'
rude	man k'o ta uk'ixb'al
rug	upopil upaja
ruin	b'enik pa k'ax
rule	taq taqanik
ruler	ajpop
rules	taqanem
run	tijoj anim
running	uchakuxik
rural	nitz' tinamit
rush	utijik anim
rush	relesaxik pa chak
rush	aninaqil
rush	ralesaxik
sack	koxtar
sacred	awas
sacrifice	q'ijilanik
safe	qas utz
safe flight	utzalaj xik'inem
safety	chajinem
sage	salb'i'a
said	b'im
sail	nik'onem
sailing	nik'onem
sake	pa ub'i' rech
salary	rajilal chi ik'
sale	k'ayij
salmon	kar
salt	xik'anik
same	kjunamatajik
Same here	Xuquje' waral
sample	k'utunsanem
sand	sanyab'
Sanskrit	Sanskrit
sarcastic	k'a'n
sassy	tzok'b'al
sat	xint'uyi'k
satisfaction	utz rilik
satisfied	utz krilo
satisfy	utz krilo
satisfying	utz chik
Saturday	uwaq q'ij
sausage	b'olob'ik ti'ij
savage	rech juyub'
save	k'olonem
saw	xinwilo
say	ub'ixik
scale	upajb'alil
scam	elaq'
scar	yuk
scarce	karaj na
scared	uxib'im rib'
scarf	tasb'al qulaj
scary	uxi'm rib'
scattered	jab'um
scene	perwachnem
scenery	Paisaj
scent	k'ok'al
schedule	cholajik
schedule	ramajil
schedule	ucholajil
schedule	ramaj
schedule	unuk'maxik
school	tijob'al
science	saqil eta'manik
scientist	ch'ob'nel
scientists	q'inom eta'manel
scissors	qupib'al
scold	yajanem
scope	ropanem
score	ch'ak'anem
scrap	kutz
scratch	k'aqatem
scream	raqoj chi'aj
screen	q'axwachib'al
screw	t'ajib'al
script	jilanjuch'
sea	polow
seal	k'ayinem
search	tzukunik
season	uq'ijol
seat	t'uyulb'al
second	alaj kajb'al
secret	owatalik
section	k'olib'al
secure	qas utz
security	chajinem
see	rilik
see you	katinwilo
see you later	kqil qawach aq'anoq
see you soon	man naj taj kinwil chi awach
see you tomorrow	kaqil qib' chwe'q
seed	ija'
seek	utzukuxik
seem	kajunamatajik
seems	kajunamatajik
seen	ilom
seize	uchapik
seizure	umajik
seldom	jun wi
select	ucha'ik
self	are' wi
self healing	tukelal kunanem
selfish	xu'y
sell	uk'ayixik
send	utaqik
send me your picture	chataqa loq jun awachib'al chi wech
senior	nim
sense	nab'alil
sensible	ch'in ranima
sensitive	k'ax kuna'o
sent	xintaqo
sentence	tz'aqat chomanik
sentences	tz'aqat chomanik
separate	upa'ixik
Sepedi	Sepedi
september	ub'elej ik'
sequence	ucholajil
series	kemq'axeb'al
serious	man katze'n taj
seriously	che tzij
serve	patanixik
service	pataninem
session	chomal
set	ya'ik
set	etz'anem
set	chapanik
set	ya'onem
set	etz'anik
set	ch'apanem
set up	ujeqeb'axik
setting	suk'manem
settle	ya'om
seven	wuqub'
seventeen	wuqlajuj
seventy	oxk'al lajuj
several	k'i
severe	nim ucholaj
sew	t'isonem
sh	sh
shade	mu'j
shadow	mu'j
shake	utotaxik
shall	rajawaxik kb'anik
shallow	nim ta qajinaq
shame	q'oxom k'u'xaj
shape	ub'antajik
share	ukomonexik
sharp	k'o uware
she	are'
she has	are' k'o
she is	are'
shed	q'u'aj
sheep	chi'j
sheet	uxaq
shelf	k'olib'al jastaq
shell	parapox
shelter	k'olib'al
shield	to'b'al ib'
shift	k'exonem
shine	repq'unem
ship	nim jukub'
shipping	utaqik
shirt	kami'x
shoes	xajab'
shoot	k'aqanem
shop	k'ayib'al
shopping	taq loq'oj
shore	uchi'
short	ko'lik
shortage	man qas ta k'olik
shot	k'aqik
shot	k'aqanem
should	rajawaxik kb'anik
shoulder	teleb'
shout	raqoj chi'aj
show	q'alajisanem
show	ilonem
show	k'utunem
show	ilonik
show	uk'utik
show	q'alajisanik
show me	chakutu' chi nuwach
shower	atinib'al
shrimp	cho'm
shrink	nitz'arem
shut	tz'apilik
shut up	man kb'an ta ch'awem
shy	kuxe'j rib'
sibling	achalal
siblings	achalaxik
sick	yowab'
side	tzal
sigh	b'isonem
sight	rilik
sightseeing	wa'katinel
sign	etal
signature	juch'b'i'aj
significant	k'o uchak upatan
silence	matzatzem
silent	matzatzem
silk	xela
silly	pay
silver	saqapwaq
similar	kjunamatajik
simp	pay
simple	retal
simultaneously	amaq'el
since	k'a pa
sincere	qas tzij k'olik
sincerely	qas tzij wi
sing	b'ixonem
singer	ajb'ixanel
single	k'ulan taj
sink	mub'anem
sink	umub'axik
sink	ukojik tzij chi rij
sink	josq'inik
sink	ch'ajol laq
Sir	Tat
sister	anab'
sister in law	ixnam
sit	t'uyulem
site	wokk'olib'al
situation	b'antajik
six	waqib'
sixteen	waqlajuj
sixty	oxk'al
size	unimal
skill	kowinem
skills	kkowin chech ub'anik
skin	tz'u'mal
skinny	b'aq
skip	uq'axexik
skirt	kut uq
sky	kaj
slave	kb'an k'ax che
sleep	warik
sleeping	warnaq
sleepy	warem
sleeve	uq'ab'
slice	jub'a'
slice	upa'ixik
slide	jilil
slightly	jutz'it
slim	b'aq
slip	jililem
slope	xulanik
slot	k'olib'al
slow	no'jimal
slowly	nojimal
small	nitz'
smart	utz chik
smell	usiqik
smile	tze'
smile	tze'nik
smile	tze'b'al
smoke	sib'
smooth	ch'uch'uj
snack	q'ajb'al
snail	t'ot'
snake	kumatz
snap	upaq'lixik uwi q'ab'aj
snow	saq tew
so	xa k'u cha'
so cute	sib'alaj utz
so far	k'a ch'anim
soak	kamul umub'axik
soap	q'eq'
sober	k'o reta'mab'al
soccer	retz'ab'exik potz'
social	kech winaq
society	komon
socks	tasb'al aqanaj
soft	ch'uch'uj
software	software
soil	uwachulew
sold	k'ayim chik
sold out	k'ayim
soldier	chajinel
sole	utukel
solid	ko
solution	usolik uwach
solve	usolik uwach
some	nik'aj chik rech
somebody	jachinaq
somehow	man jewa' ta wi
someone	jun chik
something	jun jastaq
sometimes	jujun mul
song	b'ix
soon	chanim
sophisticated	sib'alaj paqalik
Sorani	Sorani
sore	ch'a'k
sore	sib'alaj k'ax
sore	k'ax una'ik
sore throat	q'oxom qulaj
sorrow	k'ajsab'al wachaj
Sorry	Kuyu'
sort	ucholajixik
sought	xintzukuj
soul	anima
soulmate	junamil anima
sound	tanib'al
soup	uwa'l ichaj
sour	k'a
source	uxe'al
south	uqajb'al kaqiq'
space	k'olib'al
spam	spam
span	ruk'a'am
Spanish	Español
spare	uya'ik
spare	k'o uwi'
spare	ujalwach
speak	tzijonem
special	nim upatan
species	b'antajik
specific	qas rajawaxik kb'anik
spectacular	sib'alaj je'lik
speech	tzijonem
speechless	man k'o ta tzij
speed	u'aninaqil
spell	ub'ixik chi jujun tz'ib'
spend	uchupik
spent	chupum chik
spicy	poqon
spike	k'ixal
spin	usutixik
spinach	spinak
spirit	uxlab'al
spit	chub'unem
splendid	maj jewi
split	pa'ib'al
split	upa'ixik
split	ujab'uxik
spoil	umaq'el ktoq'ob'sax uwach
spoiled	qas kaya che ri karaj
spontaneous	tob'anel
spoon	lajpak'
spot	k'olib'al
spouse	ixoqilom
spread	unimal
spring	tuxq'ijol
square	kajxukut
squeeze	uyitz'ik
squid	Kalamar
squirrel	kuk
st	b'e
stab	ukojik kuchi'l
stable	utz ub'anom
stack	ch'ajo'nib'al
staff	winaqil
stage	ch'akateb'
stain	soq'onem
stairs	taq q'a'am b'e
stake	stak
stalk	ub'anik k'ax
stall	jachijib'al
stamp	retal
stand	k'olem
stand	tak'alem
stand	k'olib'al
stand	tak'ab'axik
standard	retal
star	ch'umil
start	umajik
started	xinmajij
starving	k'o unumik
state	b'antajik
state	b'antajem
state	jas ub'anik
state	uya'ik uq'alajisaxik
state	ub'anik
state	rulewal tinamit
statement	uq'alajisaxik
station	k'olib'al
statue	tz'aqom wachb'al
status	ub'antajik
stay	k'olem
stay	k'olik
stay	ch'ijonik
stay	ch'ijonem
stay safe	k'olem qas utz
steady	ko k'olik
steak	b'olom ti'ij
steal	elaq'
steam	usib'
steel	koch'ich'
steep	jech'elik
stem	ra'
step	ok'owib'al
stick	che'
stiff	ko
still	pine'
still	kab'an na
still	matzalem
still	xa k'u cha'
still	b'anik
sting	k'ix
stingy	xu'y
stir	usolik uwach
stock	b'anowem
stolen	elaq'am
stomach	pamaj
stone	ab'aj
stood	tak'alik
stool	t'uyulb'al
stop	tak'alem
storage	k'olib'al
store	k'ayib'al
storm	xkoyopa'
story	uxe'al
stove	kaxlan q'aq'
straight	suk'
straightforward	suk'
strain	q'oxom aqanaj
strange	jun wi
stranger	jun wi
strategy	ub'e'al chak
straw	jek'b'al uk'ya'
strawberry	kab'tukan
streak	soq'onem
stream	alaj b'inel ja'
street	b'e
strength	chuq'ab'
stress	q'i'tajem
stretch	yuqutajem
strict	utz kraj kb'an che
strike	uq'atexik b'e
string	kolob'
strip	ch'analem
strive	rilik che
strong	k'o uchuq'ab'
struck	b'anom k'ax che
structure	wokob'al
struggle	chuq'ab'enik
struggle	ch'a'oj
struggle	ch'ojinik
struggle	ukojik chuq'ab'
struggling	ch'a'oj
stubborn	k'ax uch'ab'exik
stuck	ch'apalik
student	tijoxel
study	eta'manik
study	eta'manem
study	eta'manel
study	tijoxel
studying	eta'manem
stuff	jastaq
stunning	mayajib'al
stupid	maj kak'am wi
style	ub'antajik
subject	ral ucholajil
submission	moch'kil
submit	upaqab'axik
substance	jastaq
substitute	k'exwachib'al
subtle	nim uchak
succeed	k'o ch'akanem
success	b'anom chik
successful	utz chik
such	pacha'
such as	pacha'
suck	utz'ub'ik
sudden	xaq k'ate'
suddenly	xaq k'ate
suffer	rech k'axk'olil
suffering	k'axk'ol
sufficient	k'iyal
sugar	asukal
suggest	uya'ik ub'ixik
suggestion	usaqil tzij
suit	atz'yaq
suit	atz'yaqinik
suit	xajb'al
suit	ukojik
suitable	ub'an rech chech
suitcase	eqab'al jastaq
sum	mulinem
summary	ch'utirinisanem
summer	saq'ij
summit	uwi'
sun	tukelal
sunday	uwuq q'ij
sunny	saqij
sunset	b'enaq q'ij
sunshine	uwachinem ri uwaq'ij
super	je'lik
superior	uwi'
supervisor	q'atunel
supper	wa rech b'enaq q'ij
supply	tzujunik
supply	tzujunem
supply	ujalik
supply	jastaq
supply	uya'ik jastaq
support	toq'ab'al
support	tob'anik
support	tob'anem
support	toq'anik
suppose	kb'an che
supposed	wene'
sure	qas utz
surface	uwi'
surge	upaqalib'al
surgery	puskunanik
surname	ukab' b'i'aj
surprise	kuk'ulumaj
surprised	ksach uk'u'x
surrender	man kb'an ta chik
surrounding	sutim rij
surveillance	ilawachinem
survey	uta'ik tzijonem
survey	usolik uxe'
survey	k'amb'ejanem
survey	uta'ik tzijonik
survive	k'aslem
suspect	chomanem
suspect	junwi rilik
suspect	chomanik
suspect	junwi
suspended	umayab'axik
suspicious	wene are b'anowinaq
sustain	uk'olik na
sustainability	tak'alib'al
sustainable	ruk'a'am rib'
swag	elaq'
swallow	utijik
swap	k'exoj
swear	usuk'ub'axik ub'ixik
sweat	k'atanal
sweater	b'ukb'al ib'
sweep	umesik
sweet	ki'
sweet dreams	utzalaj waram
sweet tooth	jiq'ol
sweetheart	Nukaj
swell	spojem
swelling	spojem
swim	muxanem
swimming	muxanem
swing	rilik ri pwaq
swing	xe'kopem
swing	xeko'p
switch	k'exonem
switch	jalk'atinem
switch	uk'exik
swollen	sipojinaq
sword	uche'l ij
symbol	retal
sympathy	katze'tzotik
symptoms	nab'anem
system	wokchakub'al
table	mexa
tackle	uk'amik b'ik
tag	retwokaj
tail	uje'
take	uk'amik
take away	uk'amik b'ik
take care	uchajixik rech
take off	uwa'lijik b'ik
taken	k'amom
talk	ch'awik
talk	tzijonem
talk	ch'awem
talk	tzijonik
talkative	kel raq'
tall	nim raqan
tap	uq'osixik
tap	tz'apib'al
tape	nak'b'al
target	ajawatajik
target	kajawaxik
target	ajawatajem
target	rilik pa
task	chak
taste	na'ik
taste	aq'
taste	ajawanem
tasty	sib'alaj je' utijik
taught	xink'utu
tea	té
teach	uk'utik
teacher	ajtij
team	wokaj
tear	upaxixik
tears	oq'ej
tease	ub'ixik tzij che
technology	kak'emeta'mab'al
teeth	ware'aj
tell	ub'ixik
tell me	chab'ij chi wech
temper	nab'ak'u'x
temperature	q'aqtewal
temple	tyox ja
temporary	xa k'o uq'ijol
ten	lajuj
ten thousand	juchuy joq'o'
tenant	qajonel
tend	uxekeb'axik
tendency	ajawanem
tender	maja'
tense	uq'ijol
tension	xb'in ib'
tent	k'ayib'al
tentative	k'amb'ejanel
term	taqanem
terms	taq taqanik
terrible	k'ax rilik
terrific	sib'alaj je'lik
territory	uwachulewil
test	k'amb'ejanik
test	k'amb'ejanem
test	rilik yawab'
test	upajik rij eta'mab'al
text	woktz'ib'
than	chi uwach
thank	tyox
thank you	maltyox
Thank you for your patience while we investigate shipment	Maltyox chech ri aweye'b'al are taq ktajin kaqil ri utaqik
thank you so much	maltyox
thank you very much	sib'alaj maltyox
thanks	tyox
Thanks for using our app	Maltyox chech ukojik we qakojkemchak
that	che
that is	are' ri'
that's good	are' ri' utz
the	ri
theft	elaq'
their	ri
them	are'
theme	upetib'al
themselves	are' xuquje'
then	k'ate ri'
theory	ub'antajik
there	chla'
there are	k'olik
there is	k'olik
therefore	xa k'u cha'
these	taq wa'
they	are'
they are	are'
thick	pim
thief	elaq'om
thigh	a'
thin	b'aq
thing	jastaq
things	taq jastaq
think	uchomaxik
third	urox
thirsty	kchaqij uchi'
thirteen	oxlajuj
thirty	juwinaq lajuj
this	we
this is	are wa'
thorough	chi uwach wachretal
thoroughly	no'jimal
those	taq are'
though	pine'
thought	b'anoj
thought	tzoqopital uchomaxik
thought	k'ulmatejem aq'anoq
thought	chomanem
thought	b'anik
thought	k'ulmatajik
thought	chomanik
thoughtful	utatab'exik
thoughts	chomab'al
thousand	kaq'o' lajk'al
thread	b'atz'
threat	ub'anik k'ax
threaten	ub'ixik kb'an ch'ayanik
three	oxib'
threshold	majib'al
thrilled	ki'kotemal
thrive	uwa'lijisaxik uwach
throat	qulaj
through	rumal
throughout	are taq chi ronojel
throw	uk'aqik
thumb	chom uwi' q'ab'aj
thunder	xkoyopa'
Thursday	Ukaj q'ij
thus	xa k'u cha'
tick	sip
tide	silob'wachaj
tidy	utz unuk'maxik b'anom
tie	jat'inik
tie	jat'inem
tie	uximik
tie	uyujik ib'
tiger	b'alam
tight	nitz'upam
Tigrinya	Tigrinya
time	uq'ijol
timid	kuxe'j rib'
tiny	nitz'
tip	tojb'al kaya kanoq
tips	pwaq kaya kanoq
tire	sutb'inb'al
tired	kosinaq
tissue	kem
title	ub'i' ch'ob'oj
to	pa
to be	b'anik
toast	uk'ilixik
today	kamik
toddler	nitz' ak'al
toes	uwi aqanaj
together	junam
toilet	b'anb'al chuluj
told	b'italil
tolerance	k'o uchijkil
tolerate	chijonem
tomato	pix
tomorrow	chwe'q
tongue	aq'
tonight	we chaq'ab' kamik
too	xuquje'
took	xink'amo
tool	chakub'al
tools	taq chakub'al
tooth	ware
top	uwi'
topic	ub'i' ch'ob'oj
torn	tzerinaq
torture	ub'anik k'ax
total	chi ronojel
touch	chapanem
tough	k'ax
tour	tour
toward	k'a pa
towards	pa
towel	su'b'al
town	tinamit
toxic	b'anol k'ax
trace	ujuch'ik
track	q'ojom
trade	k'ayij
trade	ajk'ay
trade	k'ayixik
tradition	naq'tisam ub'anik
traditional	amaq'el
traffic	ub'inem ch'ich'
trail	upaqanaj
train	jurujik ch'ich'
training	tijoxik
trait	uq'axb'al
traits	uxe'al
transfer	uq'axexik
transition	uq'axexik
translate	uq'axexik
transparent	kq'alajin upam
transport	uq'axexik
transportation	ch'ich'
trap	chapob'al
trash	mes
trauma	xb'in ib'
travel	b'yajem
tray	okib'al
treat	uch'ob'ik
treatment	ukunab'alil
tree	che'
tremendous	k'o uchuq'ab'
trend	qas k'o uch'a'ik
trial	rech uk'amb'ejaxik
trick	mayijab'al
tried	xib'ano
trigger	relesaxik ch'ich'
trigger	tzoqopinik
trigger	tzoqopinem
trigger	relexasik t'iqom ch'ich'
trim	uramixik
trip	b'yajem
trouble	k'eyowal
trousers	taq lix
truck	eq'anib'al ch'ich'
TRUE	QAS TZIJ
trunk	kutz
trust	rilik
trust	utz rilik
trust	uq'alb'al k'u'x
trust	q'alb'al k'u'xaj
truth	qas tzij
try	kraj
Tsonga	Tsonga
tube	q'axb'al jastaq
Tuesday	ukab' q'ij
tuition	tojb'al chi ik' rech tijob'al
turkey	no's
turmeric	Kurkuma
turn	usolkopixik
turtle	kok
tutor	chajinel
twelve	kab'lajuj
twenty	juwinaq
twenty-one	juwinaq jun
Twi	Twi
twice	kamul
twist	b'aq'atinem
two	keb'
type	ub'antajik
typical	junelik kb'anik
ugly	itzel
ultimate	uk'isb'al
umbrella	q'atb'al jab'
unable	man k'o ta ukowinem
uncle	ch'utitat
unconscious	man junam taj
under	chi uxe' rech
underneath	chi uxe'
underrated	man qas ta kaya uq'ij
understand	uch'ob'ik
understood	xinch'ob'o
unfortunately	xa k'ut man jeta xub'ano
uniform	junamil
unique	tukelal
unit	jujunal
university	nim tijob'al
unknown	man eta'matal taj
unless	ruk' we
until	k'a pa
unusual	man qas ta kkojik
up	ajsik
up to you	at katchomanik
update	uk'ak'arisaxik
update	ub'anik utz che
update	k'ak'arisanem
upgrade	uwa'ljisaxik uwach
upgrade	wa'lijisaxik
upgrade	uk'ak'arisaxik
upgrade	ub'anik utz che
upgrade	k'ak'arisanem
upon	pa uwi'
upset	k'ax una'om
urban	nim tinamit
urge	aninaqil rij
urge	q'aq' rij
urge	aninaq
urge	pa aninaqil
urgent	aninaqil rij
us	oj
use	ukojik
use	kamul ukojik
use	uchokonsab'exik
use	chokonsab'exik
used	kojom
useful	kachokonik
useless	man k'o ta kachokon wi
usual	qas kkojik
usually	amaq'el wi
utility	chokonsab'al
vacation	q'ij rech uxlanb'al
vaccination	taq t'isb'aq
vaccine	t'isb'aq
vacuum	kaxlan meseb'al
vague	pa b'e kak'oji' wi
valid	utz
valley	b'eya'
valuable	nim upatan
value	ub'antajik
value	rajilal
value	man kuxe'j ta rib'
value	upatan
variety	k'i ub'antajik
various	k'i
vary	ujalik uwach
vase	alaj xa'r
vast	nimarisam
vegetable	ichaj
vegetables	ichaj
vehicle	ch'ich'
vendor	ajk'ay
venom	itzel kunab'al
venture	ub'anik wi
venue	wokk'olib'al web'
verify	uk'amb'ejaxik
versatile	k'extajem
version	okib'al
vertical	tak'alik
very	sib'alaj
very good	utz la'
vessel	uk'yab'al
via	b'e
vibe	silab'em
vibes	silab'em
vicious	knaq'tisax ukojik
victim	b'anom k'ax che
video	silob'wachib'al
view	rilik
village	alaj tinamit
villain	b'anal k'ax
vinegar	ch'am joron
vintage	ojer
violence	ub'anik k'ax
violent	b'anal k'ax
viral	viral
virgin	q'apoj
virtual	pa kematz'ib'
virtue	uchuq'ab'il
vision	ilb'al
visit	usolixik
visit	ula'
visit	solinem
visual	visual
vital	qas are wi
vivid	b'anom k'olem chi upam
vocabulary	choltzij
voice	ch'ab'al
void	man utz taj
volume	uchuq'ab'
volunteer	man tojtal taj
vomit	uxa'wachik
vomit	xa'oj
vomit	xab'ik
vomit	xa'wik
vulnerable	man k'o ta uchuq'ab'
wage	chak'oj chi ik'
wages	ch'akoj chi ik'
waist	ximb'al
wait	reye'xik
waiter	q'axel wa chi uwi' mexa
waiting	weye'j na
wake	waranik
wake up	k'astajem
walk	b'inik
walk	b'inem
walk	wa'katik
walk	wa'katem
walking	wa'katem
wall	uwaxan
wallet	k'olib'al pwaq
wander	wa'katel pa taq b'e
wanna	ajawatajem
want	ajawatajem
wanted	xwaj
war	ch'a'oj
wardrobe	k'olib'al atz'yaq
warehouse	k'olib'al
warm	oyowarik
warm	yowajik
warm	oyowal
warm	yowajem
warm	umeq'saxik
warm	q'aq'
warn	uya'ik ub'ixik
warning	q'ilb'al
warrior	ajch'oj
was	xb'e
wash	uch'ajik
waste	tzaqik
waste	tzaqem
waste	ub'anik k'ax che
waste	mes
watch	rilik
water	ja'
watermelon	q'anq'oq'
wave	uq'e't polow
way	b'e
we	oj
we are	oj
we can	kojkowinik
weak	maj uchuq'ab'
weakness	ri man kkowin ta che
wealth	q'inomal
wealthy	utz
wear	uk'amik
wearing	ktajin uk'amik
weather	q'aq'tewal
wedding	k'ulanem
Wednesday	Urox q'ij
weed	q'ayes
week	wuqq'ij
weekend	uk'isb'al q'ij rech ri wuq taq q'ij
weight	upajik
weight	ra'lal
weight	pwaq
weird	jun wi
welcome	utz apetik
welfare	utzwachil
Well	Utz
well done	sib'alaj utz
went	xinb'ek
were	xeb'ek
west	uqajb'al q'ij
wet	ch'aqalik
whale	mataq'tami'
what	jas uwach
what about you	jas uwach chi awij
what are you doing	jas ktajin kab'ano
what are you doing now	jas ktajin kab'an chanim
what are you doing right now	jas ktajin kab'an chanim
what do you do	jas kab'ano
what do you do for a living	jas kachakuj
what do you mean	jas kawaj kab'ij
what do you want	jas kawaj
what happened	jas xk'ulmatajik
what is	jas uwach
what is this	jas uwach wa'
what is your job	jachike achak
what is your name	jas ab'i'
what's up	jas kak'ulmatajik
what's your name	jas ab'i'
whatever	apas uwach
wheat	tirko
wheel	sutb'inb'al
when	janik'pa'
whenever	janipa' nuk'ut
where	jawije'
where are you	jawije' at k'o wi
where are you from	jawije' katpe wi
where are you now	jawije' at k'o wi chanim
where do you live	jawije' katel wi
where is	jawije' at k'o wi
whereas	ruk' rilik
whether	je'
which	chike
while	are taq
whisper	jasjatem
whistle	xulq'ab'em
white	saq
who	jachinaq
who are you	jachin at
who is	jachinaq
who is this	jachinaq
whole	tz'aqat
whom	jachinaq
whose	jachin ajchoq'e
why	jas che
why not	jas che ja'i'
wicked	itzel
wide	nim
widow	malka'n ixoq
width	uwach
wife	ixoqilom
wild	rech juyub'
will	kraj ub'anik
will	lal
will	uchanem
will	ajawanem
willing	karaj kub'ano
win	ch'akanem
wind	kaqiq'
window	wanta'n
windy	kaqiq'
wine	vino
winter	uq'ijol jab'
wipe	uq'axexik jun q'etal
wire	alambre
wisdom	eta'manik
wise	aj no'j
wish	ajawanik
wish	ajawatajem
wish you all the best	ronojel ta b'a' utz xub'an chi awach
witch	ajitz
with	ruk'
withdraw	relesaxik
withdrawal	elem b'ik
within	chi uwapan rech
without	man ruk' taj
witness	k'olem
witness	k'olik
witness	kojol tzij
witness	rilik
witness	ilowinaq
witty	k'o reta'manem
wolf	utiw
woman	ixoq
women	ixoqib'
won	xinch'akanik
won't	man kb'an ta b'enam pa
wonder	uta'ik
wonderful	sib'alaj je'lik
wood	tz'alam
wool	rij chij
word	tzij
words	taq tzij
work	patanixik
work	chakunem
work	uchakunem
work	upatan
work	chakunik
work	b'anik
work	ub'anik
work out	ktajin kchakun apanoq
working	ktajin kchakunik
world	uwachulew
worm	xujut
worn	xink'am b'ik
worried	kmayowik
worry	mayowem
worse	sib'alaj k'ax
worship	q'ijilanem
worst	k'axk'ol
worth	k'o upatan
worth it	qas tzij che are na
worthy	ya'tal che
would	kraj
wound	sokotajem
Wow	Wow
wrap	upisik
wrath	oyowal
wrist	ala's
write	tz'ib'anik
Write here	Tz'ib'aj waral
writing	tz'ib'
written	tz'ib'wuj
wrong	man utz taj
wrote	xintz'ib'aj
yard	uwaja
yawn	warik
yawn	k'ab'oj chi'aj
yawn	waram
yawn	uk'ab'ik chi'aj
Yeah	Je'
year	junab'
years	taq junab'
yeast	sipojisab'al
yell	uraqik chi'aj
yellow	q'an
Yes	Je'
yes baby	se katijo
yes dear	je' loq'alaj
yes honey	je' loq'alaj
yes my love	je' nuloq'ob'al
yes of course	jela'
yes of course	je'
yesterday	iwir
yet	maja
yield	ajawatajem
you	at
you are	at
you are beautiful	ri at sib'alaj at je'lik
you are so beautiful	at sib'alaj at je'lik
you are welcome	maj kub'ano
you can	at ktkowinik
You know	At aweta'am
you too	xuquje' at
you're welcome	maj kub'ano
young	ala
your	at
your welcome	maj kub'ano
yourself	at ri'
youth	k'ajolal
you’re welcome	maj kub'ano
yummy	sib'alaj utz
zero	maj
