Langai	a
kaji sha	a little
zup	a lot
grai law hkra	a lot
law htam ai	a lot of
grai law hkra	a lot of
myit daw mat ai	abandon
kabai kau ai	abandon
kam mara rai nga ai lam	abandon
kabai kau ai	abandoned
kabai tawn ai	abandoned
myit galu ai	abide
grin ai	abide
ga sadi dung ai	abide
atsam	ability
dang di ai	able
daram	about
a lam	about
hta e	above
ntsa	above
maigan mungdan	abroad
n nga ai lam	absence
n du dung lawm ai lam	absence
n sa du ai wa	absent
n du dung lawm ai	absent
n nga ai	absent
hkrak tup	absolutely
chyup la ai	absorb
myit chyung ai	absorb
myit lawm ai	absorb
myit hte seng ai	abstract
ga machyim	abstract
ga n se	abstract
n teng n man ai	absurd
lachyum n pru ai	absurd
grai law htam ai lam	abundance
nhpaw n-ya re ai lam	abundance
ntaw ntsang	abundant
nhpaw nya	abundant
matsut jaw ai	abuse
yu tsaw yu nyem nsen	accent
n sen nyem tsaw hte shaga ai	accent
hkap la ai	accept
mahkrun	access
lam	access
hkala nba	accident
sa shara	accommodation
nga shara	accommodation
ngut kre ai	accomplish
shangut shakre ai	accomplished
hte maren	according
jahpan	account
hkrak re ai lam	accuracy
tup hkrak ai lam	accuracy
hkrak	accurate
hkrak hkrak	accurate
tup hkrak	accurate
shadu da ai	accused
mara shagun kau ai	accused
nachying machyi ai	ache
ka ut machyi ai	ache
hkam la lu ai	achieve
awngdang la lu ai	achieve
hkam la lu ai	achievement
masat masa galaw ai	acknowledge
hkam la ai	acknowledge
mawn yu ai hparat	acquaintance
chye manang	acquaintance
hka ja ai	acquire
shakung ai	acquire
lu la ai	acquired
hka ja la ai	acquired
lu tam la ai rai	acquisition
lu la ai lam	acquisition
tang tang	across
lai nna	across
shamu shamawt ai	act
galaw shabyin ai	act
galaw ai	act
hkrang shala ai	action
zet tsang ai	active
kasang kalang re ai	active
shamu shamawt ai lam	activities
galaw ai bungli	activities
shamu shamawt lam	activity
jasu alun ya ai arai	activity
sumla hkrung shadang	actor
kaja ngu yang	actual
tatut hta	actual
kaja ngu yang	actually
myit gat ai	acute
nsen kachyeng ai	acute
laja lana re ai	acute
htap htuk hkra galaw la ai	adapt
jahtuk jahkrak la ai	adapt
jat ai	add
bang ai	add
ya byin ai wa	addicted
lu sha shaman kau ai	addicted
ya byin wa ai	addicted
jat la ai rai	addition
kahkyin bang ai lam	addition
ningtau re ai	additional
kahtap jat la ai hte seng ai	additional
hparen ai	address
hkring dat	address
tsup ai	adequate
ra n rawng	adequate
saw na	adjacent
makau kaw na	adjacent
mying shadan	adjective
shadawn ai	adjust
sharai ai	adjust
shakawn ging ai	admire
ra sharawng ai	admire
hkungga ai	admire
yin la ai	admit
hkam la ai	admit
hkan sa galaw ai	adopt
shagrin masat la ai	adopt
bau la ai	adopt
ra tsaw awng sharawng na zawn re ai	adorable
yu ra shingni	adorable
rawt jat ai	advance
htang da ai	advance
ga la ai	advance
jaram	advanced
rawt jat wa ai	advanced
galu kaba wa ai	advanced
akyu ara	advantage
nhkrit ntsang galaw ai lam	adventure
laklai mahkrum madup	adventure
ga shadan	adverb
ndau shabra ai lam	advertisement
ndau shabra laika	advertisement
tsun shana ai	advertising
ndau shabra ai	advertising
nsen shapoi ndau ai	advertising
hpaji jaw ai	advice
bawng	advice
hpaji jaw ai	advise
bawngban jahkrup ai	advise
shiga tsun shana ai	advise
tara kasa	advocate
madi shadaw tsun garum ai	advocate
tsawm htap ai hta myit jung ai hte seng ai	aesthetic
amu magam	affair
galaw ra ai magam	affair
byin nga masa	affair
kang ai	affect
nyam ai	affect
ana ahkya	affection
shawang myit	affection
tsawra myit	affection
dang di ai	afford
dang dep ai	afford
dang di dang dep ai	affordable
hkrit ai	afraid
tsang ai	afraid
ngut ai hpang	after
shani ka-ang	afternoon
shawng de myit mada let	afterwards
kalang bai	again
hpang kalang	again
ninghkap ai	against
asak	age
dat kasa rung	agency
dat kasa dap	agency
ka ang masha	agent
pawt sindawng ai	aggressive
zet let ai	agile
zet tsang ai	agile
lai wa sai ten	ago
myit hkrum ai	agree
hkawn ai	agree
hkap la ai	agree
myit hkrum lam	agreement
ga shaka lai ka	agreement
hkai mu hpaji	agriculture
hkai sun hpaji	agriculture
shawng de	ahead
shawng	ahead
garum madi shadaw ya ai	aid
garum shadaw ai lam	aid
shading ai	aim
di	aim
ban dung	aim
nbung	air
nbungli pa	airport
nbungli daru	airport
lahkum lapran hkawm lam	aisle
hkrit hpa lam du na hpe tau nna shadum ai lam	alarm
hkrit kajawng ai lam	alarm
lauhku	alcohol
chyaru tsa	alcohol
maja let nga ai ten	alert
maja let nga na matu sadi jaw ai nsen	alert
mahkran ai myit	alert
shamu shamawt nga ai	alive
shagrin tawn ai	alive
chyahkrung re ai	alive
yawng	all
rai sai	all right
kaja dik ai lam yawng	all the best
ahkang jaw ai	allow
lam hpaw ya ai	allowed
ahkaw ahkang jaw ai	allowed
ganoi	almost
yawng ngu na ram	almost
langai hkrai	alone
shingtai	alone
ding yang	along
ngut sai	already
magang	already
Rai sai	Alright
rau	also
mung	also
kaga	alternative
raitim mung	although
galoi mung	always
aten tup	always
ayen na	always
mau hpa	amazing
lachyum ndan leng ai	ambiguous
nrup ntsen hpa re ai	ambiguous
yaw shada lam	ambition
grai byin mayu ai myit	ambition
ra sharawng myit	ambition
myit da ai bandung	ambitious
gram lajang ai	amend
grau kaja hkra galaw ai	amend
galai kau ai	amend
kata kaw	amid
ka ang kaw	amid
lapran	among
anhte lapran	among us
jahpan	amount
mani pyaw mai ai	amusing
gawn yu ai lam	analysis
myit san jep yu ai lam	analysis
npawt ndung jep yu ai lam	analysis
jiwoi jiwa	ancestors
kaji kawoi	ancestors
sanghpaw dun ai hpri chying hkyi	anchor
hpri chying hkyi jahkrat ai	anchor
moi na	ancient
shawng ninghpawt	ancient
chaloi nhkoi	ancient
Hte	and
nang gaw	and you
nang taw	and you
sumnung shingdi ai wa	angel
lamu kasa	angel
mara nkap ai wa	angel
masin pawt un ai	anger
sinpawt la htet	anger
nga myek ai	angle
maga mi tingkyeng nna shiga tang madun ai	angle
mada yu ai shara	angle
masin pawt	angry
ka un ai	angry
shapawt ai	angry
du sat	animal
lakre	ankle
ladu hkrum	anniversary
ndau shabra ai lam	announcement
shana shabra ai lam	announcement
myit shanuk shangun ai	annoy
ahtu ai	annoyed
dingsa ai	annoyed
shatsang ai	annoyed
myit jashuk ya ai	annoying
shaning shagu	annual
mying n chye ai wa	anonymous
laga langai	another
kaga langai	another
mahtai	answer
htai ai	answer
nau nna galaw ai	anticipate
tau hkrau n na	anticipate
shawn di chye ai	anticipate
myit shuk lam	anxiety
myit tsang ai lam	anxiety
myit pu ai lam	anxiety
tsang ai	anxious
gara tim	any
ya	anymore
matut nna	anymore
kadai rai rai	anyone
hpa raitim	anything
hpa mi nga nga	anyway
gara hku mi raitim	anyways
gara hku mi nga nga	anyways
kaga san re ai	apart
kaga ran di ai	apart
hka gara mat ai	apart
tsan tsan	apart
gawk	apartment
hpyi shawn ai	apologize
hpyi nyem ai	apologize
asan re ai	apparent
dan leng ai	apparent
dan dawng ai	apparent
mawt	apparently
hpyi lajin ai	appeal
akroi anoi hpyi lajin ai	appeal
shadan ai	appear
dan pru ai	appear
hkrang sai	appear
nsam	appearance
dan pru wa ai	appeared
du sa wa ai	appeared
paw pru wa ai	appeared
n-gup nam ta	appetite
namta	appetite
ja makawk si	apple
makawk si	apple
shawk shawn ai	application
chya ai	application
jai lang ai	application
shawk ai	apply
jai lang ai	apply
masat da ai shara	appointment
masat da ai ten	appointment
masat masa galaw ai	appreciate
sharing hkungga ya ai	appreciation
grai manu shadan ai	appreciation
ladat	approach
htuk manu ai	appropriate
ra sharawng lam	approval
myit hkrum ya ai lam	approval
hkap la ya ai	approve
ra sharawng ya ai	approve
shagrin da ai	approve
myit hkrum ya ai	approve
shagrin da ai	approved
myit hkrum ya ai	approved
daram	approximately
shala ta	april
kam mara re ai	arbitrary
myit shading ai	arbitrary
nta gaw gap kajang ai wa	architect
htinggap ninghkring	architect
gawgap hpaji	architecture
hkam la lu ai	archive
hkap la lu ai	archive
re ma ai	are
rai ma ai	are
nang gaw	are you
Nang kyin taw ai i?	are you busy
dinghku hte re i	are you married
nang dinghku de sai i	are you married
dinghku hte i shingnrai shingtai i	are you married or single
Nang dai kaw sha naw re i?	Are you still there?
nang dai kaw re i	are you there
lamu ga	area
ginra	area
dara hkat ai	argue
ashai ai	argue
ga law ai	argue
dang rang ai lam	argument
ndang kalang	argument
rawt sa ai	arise
lung wa ai	arise
lahpum	arm
hpyen la	army
grup	around
shachyip ai	arrange
tau hkrau hkyen lajang ai	arrange
hkyen lajang ai lam	arrangement
shachyip ai lam	arrangement
du sa ai lam	arrival
du dep ai	arrival
du wa ai	arrival
du ai	arrive
gale ai	arrive
du ai	arrived
gale ai	arrived
raidum ai	arrogant
myit ja ai	arrogant
gawng ai	arrogant
pala	arrow
lashi pala	arrow
shingni hpa ji	art
si mani hpaji	art
shaman hpaji	art
sumroi	article
ta hte galaw ai	artificial
sumla sara	artist
zawn	as
ding sa	as long as
mung	as well
mung	as well as
dap	ash
kaya kahpa	ashamed
san ai	ask
hpyi ai	ask
san ai	asked
jep ai	asked
yup pyaw ai	asleep
yup malap taw ai	asleep
nsam	aspect
ningmu	aspect
Assamese	Assamese
gasat ai	assault
htim gasat ai lam amu	assault
rapdaw zuphpawng	assembly
zuphpawng shara	assembly
madu hkum madu kam lai ai lam	assertive
dinglik ai	assess
sagawn ai lam	assessment
gwi gwi tsun ai	asset
nlawm nmai ai rai	assets
madu lu ai rai	assets
apnawng ya ai	assign
masat da ai	assign
lit apnawng ai	assign
lit	assignment
bungli	assignment
karum ai	assist
lakawn ai	assist
ningrum ningtau di ai	assist
garum ai wa	assistant
ningtau	assistant
mazum ai	associate
kanawn ai	associate
kanawn manang	associate
hkau chyap ai	associated
kanawn mazum ai	associated
hpung	association
hkam la ai	assume
hkam la ai lam	assumption
galaw masu ai lam	assumption
matsing la ai lam	assumption
hta	at
kaw	at
yawm dik	at least
sha ai	ate
ginsup ninghkring	athlete
noi ai	attach
shakap ai	attach
kap ai	attach
let	attached
noi ai	attachment
shakap ai	attachment
kap ai	attachment
gasat ai	attack
hpyen htim ai	attack
htim ai	attack
shakut ai	attempt
lung ai	attend
shang lawm ai	attend
rung lung ai lam	attendance
sa du ai lam	attendance
myit maju jung ai	attention
arawn alai	attitude
myit masa	attitude
Ning mu	attitude
mawng ai	attract
myit shakap la ai	attract
gang ai	attract
mawng ai lam	attraction
myit shakap la ai lam	attraction
yu ra shingni	attractive
shingkang	attribute
seng ang ai	attribute
nsam kumla	attribute
shawa masha	audience
gupshi ta	august
A tung	aunt
a moi	aunty
a tung	aunty
ajet re ai	authentic
majing sawng	authentic
laika ka sara	author
laika ka ai wa	author
ahkang aya	authority
daru magam	authority
nmut ta	autumn
lu mai ai	available
mai lu ai	available
lapran	average
htang da ai shadawn shadang	average
koi yen ai	avoid
koi gam ai	avoid
yup jasu ai	awake
yup hprang ai	awake
kumhpa shagrau ai	award
shagrau kumhpa jaw ai	award
shagrau kumhpa	award
maja ai	aware
sadi ai	aware
maja ai	awareness
ningmu jahpaw ai	awareness
sadi ai	awareness
tsan ai	away
grai hkrak ai	awesome
mauhpa	awesome
tsawmra mi n kaja ai	awful
n chye n kaw re ai	awkward
apai ai	awkward
Aymara	Aymara
manga	baby
brang tung brang la	bachelor
hpang de	back
hting nut ai	back
shingdu na	background
n kaja ai	bad
nhpye	bag
nga n shat noi ai	bait
nga myek shat	bait
nga shat bang ya ai	bait
kakang ai	bake
kabaw ai	bake
ju ai	bake
muk galaw ai shara	bakery
muk ju shara	bakery
muk ka kang ai kaw lang ai hpan	baking soda
joi jang ai	balance
gaw din	ball
Bambara	Bambara
langu si	banana
adawt nsen	band
gyit hkang ai	band
dum sumpyi hpung	band
gayat nsen ngoi ai	bang
ma ja gayat ai	bang
gumhpraw dum	bank
hka hkin gau	bank
tsa seng	bar
dinggrang	bar
sha naw	barely
dai ram sha	barely
manu dara ai	bargain
hpun hpyi	bark
gwi wau ai	bark
hpun kawp	bark
n nga ai daram	barley
ram sha	barley
numdaw numdan	barrier
dingbai ai rai	barrier
ningpawt	base
npawt ru di	base
mahta nna	based
ga npu htap	basement
ru di ru hpang hte seng ai	basic
npawt nhpang	basic
ru di ru hpang hku ngu yang	basically
shingtawn pan	basil
ninggyi	bastard
masha pang	batch
pang	batch
hka shin ai lam	bath
kashin kamun ai	bath
hka shin gawk	bathroom
wan dek	battery
nga rai wan dek	battery
majan pa	battle
gwi wau ai	bay
hpung jut	bay
sadi saka u	be careful
panglai hkin gau	beach
ngau ring	beam
naw kwi	beans
naw lep	beans
shapre ni	beans
tsap	bear
nhka mun	beard
hkawm sa shamu shamawt	bearing
sat lawat	bearing
du sat	beast
matse labye	beast
adup ai	beat
dum ai	beat
gayet ai	beat
Tsawm ai	beautiful
Tsawm htap ai	beautiful
sari rawng ai lam	beauty
tsawm htap ai lam	beauty
byin wa ai	became
hpa majaw nga yang	because
hpa majaw ngu yang	because
tai ai	become
byin wa ai	become
yup ra	bed
yup ku	bed
yup gawk	bedroom
lagat	bee
nga shan	beef
tsa hku	beer
chyaru	beer
ndu shi yang	before
nrai shi yang	before
hpaw hpang ai	began
npawt sharawt ai	began
hpang ai	begin
npawt nhpang	beginning
malai	behalf
gawng malai	behalf
hkawm sa ai	behave
kanawn mazum ai	behave
jak kyi ai	behave
akyang	behavior
sat la wat	behaviour
lai nsam	behaviour
hpang kaw	behind
hpang de	behind
ngam kau da sai	behind
makam masham	belief
kam sham ai lam	belief
kam hpa ai	believe
kan	belly
seng ai	belong
nja nhpra re ai	beloved
nachying tsawra ai	beloved
npu e	below
npu kaw	below
shingkyit	belt
dunghkum galu	bench
gum dagup ai	bend
magaw ai	bend
npu	beneath
akyu ara	benefit
hkam la lu ai akyu	benefits
akyu chyeju	benefits
makau e	beside
hta n-ga	beside
makau mayang e	beside
makau	besides
kaja dik htum	best
gam kaja u ga	best of luck
gam kaja dik u ga	best of luck
hkungga let	best regards
kaja dik htum	better
lapran	between
lu hpa ntsin	beverage
malum ntsin	beverage
tawt lai	beyond
de hpang	beyond
dawn jan ai	beyond
Bhojpuri	Bhojpuri
myi man lata ai	bias
maga ai	bias
myiman lata ai	biased
lagaw leng	bicycle
shaw shingjawng gat hta manu jaw ai	bid
karam ga tsun ai	bid
kaba ai	big
lagaw leng	bike
shabrai	bill
hkang ai	bind
gyit ai	bind
u	bird
shangai nhtoi	birthday
loi mi	bit
ga wa ai	bite
makret	bite
achye	bite
hka ai	bitter
ahka	bitter
achyang amang	black
chyang ai	black
ningshan	blade
mara shagun ai	blame
shara ai	blame
kaman re ai	blank
hpa jawng	blanket
hpun nba	blanket
kapaw ai	blast
hpraw hkra galaw ai	bleach
jahpraw kau ai	bleach
gayau gaya di ai	blend
pan gayau ai	blend
shaman ya ai	bless
shaman ya u ga	blessed
kyaw ai	blind
myi n mu ai	blind
a lu ai lam	bliss
a lu ai chyeju	bliss
lawk	block
tawng	block
pat shingdang ai	block
sai	blood
pu pu ai	bloom
ahpawt ai	blow
bung ai	blow
hpyi	blow
chyamut	blue
maw	blue
amaw	blue
dup dup re ai	blunt
mungbawng hpung	board
hpun pyen pa	board
hkali	boat
li	boat
hkum hkrang	body
prut ai	boil
shadu shaprut ai	boil
gwi ai	bold
dan dawng ai	bold
mu mada ai	bold
lit la ai	bond
ga shaka ka ai	bond
myit hkrum ai	bond
nra	bone
laika	book
laika buk	book
shagreng ai	boost
shagreng ai	booster
kyepdin	boot
kyep din	boots
htungdin	boots
lamu jarik	border
nkam mat ai	bore
jin mat ai	bore
lau mat ai	bore
lagawn	bored
ajin aban	bored
lagawn ai	boring
ajin aban	boring
shangai ai	born
hkoi ai	borrow
shap ai	borrow
lauban	boss
sa hte	boss
Lahkawng yen	both
kanau	bother
kahpu	bother
dumlawng	bottle
soi	bottle
hka ndum	bottle
ndum	bottle
npawt	bottom
htum pa	bottom
mari wa ai	bought
gumtsat ai	bounce
kahtan ai	bounce
masat da ai lam	bound
lam masat ai	bound
lamu ga jarit	boundaries
gum ai	bow
hka wan	bowl
sumpu	box
htwi ai	box
sadek	box
la kasha	boy
sumtsaw	boyfriend
manang la	boyfriend
lahkawn	bracelet
baw nu	brain
lakung	branch
laking	branch
wan nhtaw	brand
dazik	brand
mazut ai	brave
magrau grang ai	brave
shada sadi hka mat ai lam	breach
muk	bread
ga	break
di	break
daw hten ai	break
jahpawt shat	breakfast
sinda	breast
chyu tauba	breast
madoi chyu hpang	breast
nsa sa ai	breath
nsoi nsa	breath
nsa sa ai	breathe
jat wa ai	breed
mayat wa ai	breed
rem ai	breed
wut tawng	brick
num ningnan	bride
num nnan	bride
mahkrai	bridge
ntsa lam	brief
kabrim ai	bright
htoi tu ai	bright
htoi ala ai	brilliant
mala shala ningtawn dik ai	brilliant
la sa wa ai	bring
ba	bro
chyam hkra	broad
dam lada ai	broad
nsen shapoi ai	broadcast
shiga	broadcast
ga mat ai	broke
hten mat ai	broke
hka bra ai	broken
ga ai	broken
ding ye	broom
dun ye	broom
kanau	brother
kahpu	brother
hkau	brother in law
la sa wa ai	brought
amang nsam	brown
amang re ai	brown
arut ai	brush
arut ahpu ai rai	brush
hka pung	bucket
manang	buddy
gumhpraw jahpan	budget
shakrep	bug
gap ai	build
gaw ai	build
nta	building
gaw gap ai	building
gaw gap ai	built
shachyaw ai	built
lit kaba ai rai	bulk
wawm ai rai	bulk
law ai rai	bulk
dumsu u la	bull
nga u la	bull
u su	bull
manang hpe n-gun hte roi a ra di ai wa	bully
n-gun ja shakawng ai wa	bully
roi sha ai	bully
dang sha ai	bully
adawt hkra ai	bump
sumbaw	bunch
u raw	bunch
shing kyang	bunch
majaw	bundle
makai	bundle
abyen	burden
lit li shangun ai	burden
wan nat kau ai	buried
wan hkru hkang nma	burn
nat kau ai	burn
wan nat jahten kau ai	burn
awng ai	burst
makoi mayang ai	bury
lup makoi ai	bury
shawa jawn mawdaw kaba	bus
sum wum	bush
nbyap	bush
hpaga	business
magam	business
bungli	business
num sinda	bust
kyin taw ai	busy
raitim	but
avogadu	butter
ahpyawk ai	butter
pilam la	butterfly
hkai dang	button
pa chyin	button
mari ai	buy
marang e	by
hte	by
shakram dat ai	bye
chyinghkrang ba hkaw	cabbage
bahkaw	cabbage
sumhtang	cabinet
rapdaw rung	cabinet
u rawng	cage
u ra	cage
hkawp ai	cake
udi muk	cake
lagaw labawp	calf
magwi hkalung	calf
dumsu	calf
matut mahkai ai	call
shaga ai	call
ngai hpe shaga rit	call me
nga ma ai	called
shamying ai	called
shaga ai	called
shazim ai	calm
sim ai	calm
sa wa ai	came
sa du ai	came
gasat gala lam	campaign
dang di lu ai	can
n dang di lu ai	can't
n galaw lu ai	can't
dawm kau ai	Cancel
shabai ai	Cancel
mawng ana	cancer
dang di ai	capable
galaw lu na atsam	capacity
ka-ang	capital
ga baw	caption
rim bang ai	capture
rim la ai	capture
mawdaw	car
kan bau bungli	career
bungli	career
sadi	careful
htau li htau la re ai	carefully
sadi maja ai	carefully
ndum ndam re ai	careless
ahpa atang galaw ai	careless
sadi ntawn ai sha	careless
lanu lahku ai	caring
lakawn ai	caring
lak sama	carpenter
sagu panyep	carpet
hkrang pawt	carrot
hpai ai	carry
gun hpai ai	carry
matut u	carry on
matut n na galaw u	carry on
galaw shabyin ai	carry out
mabyin	case
masa	case
gumhpraw	cash
hkrang shala ai	cast
numhkap	castle
langchyi	castle
n myit mada ai sha	casual
kajawng kaja	casual
lanyau	cat
nyau	cat
lu ai	catch
hkwi la ai	catch
rim la ai	catch
amyu baw hpan	category
pang	category
dum su	cattle
yam nga	cattle
rim ai	caught
byin masa	cause
tau shawng sadi jaw ai	caution
hprang maja ai	cautious
sadi sahka myit rawng ai	cautious
ginlawng hku lungpu	cave
gyi mat ai	cave
lung hkrung	cave
ngap ai	cease
hpawng mat ai	cease
shangap kau ai	cease
magaw	ceiling
masat poi galaw ai	celebrate
gawk kaji	cell
dat kawk	cell
ka ang	center
latsa ning	century
jaw prat	century
mam	cereal
nai mam	cereal
poi shingra	ceremony
malawm ni	certain
shang lawm ai	certain
nan	certain
teng ai	certain
teng sha	certainly
teng teng	certainly
lakmat	certificate
sakse laika	certificate
sai ru	chain
sai dawng	chain
dunghkum	chair
ning dat ai	challenge
ahkaw ahkang	chance
galai shai ai	change
myit lai ai	change
sat lawat	character
lai kyang hte seng ai	characteristics
manu jahpu	charge
lit nga ai	charge
htim ai	charge
karum kahtau bungli	charity
ningja rawng ai	charming
tsawm htap ai	charming
chyarang lawk	chart
sumla	chart
hkan rim ai	chase
hkan nang ai	chase
tsun shaga chyai ai	chat
jahta chyai ai	chat
manu hpa ai	cheap
hkyem sa ai	cheap
mawp sha ai	cheat
masu sha ai	cheat
maw sha ai	cheat
maw sha nga ai	cheating
mawp sha nga ai	cheating
masu sha taw ai	cheating
san jep ai	check
jep joi ai	check
sha byi	cheek
myit pyaw	cheer
kabu sum sai ai	cheer
kabu ai	cheerful
pyaw ai	cheerful
kabu gara ai	cheers
chyu sau muk	cheese
nga chyu muk	cheese
dat jasat hpaji	chemistry
shagrau aw law ai	cherish
manu shadan la ai	cherish
chess ginsup ai	chess
sinda	chest
shat lai lai ai	chew
maya ai	chew
u	chicken
u hkai kasha	chicken
ningbaw	chief
kaba htum re ai	chief
du	chief
ma	child
ma prat	childhood
ma ni	children
katsi ai	chill
wan hkut shadaw	chimneys
nhka	chin
hkang amyu	chin
lata la ai ahkang	choice
lata san ai lam	choice
lata ai	choose
azat ai	chop
achye ga ai	chop
atawk ai	chop
nta bungli	chores
di di re ai	chubby
abau adi re ai	chubby
nawku jawng	church
maza shamu hpun	cinnamon
hpun shaman	cinnamon
shing wang	circle
ting wang	circle
masa	circumstances
mungdan masha	citizen
mare	city
hpyi shawn ai	claim
aja awa tsun ai	claim
hpyi ai	claim
tsun jahpra dan ai	clarify
tsun shaleng dan ai	clarify
baw hpan	class
atang	class
tsang madang	class
htu gyi	clay
kagam ga	clay
san seng ai	clean
hkoi ai	clear
san ai	clear
akrin re ai	clear
chyare	clerk
ram ai	clever
rai mari ai wa	client
amu hkrum ai wa	client
ning gam	cliff
du hkra ladaw	climate
lung ai	climb
kap sha ai	clingy
NA kap taw ai	clingy
hkying hkum madun jak	clock
Na ri	clock
pat ai	close
ni ai	close
ni htep ai	close
rai da gawk	closet
sumpan	cloth
bu hpun palawng	clothes
wam wam sumwi	cloud
sumwi	cloud
lamu mung ai	cloudy
pan hte	clown
shing chyai chyai wa	clown
mau hte	clown
byin sa majun	clue
sumbaw	cluster
shingkyang	cluster
sara	coach
nhprang wan n-ga	coal
hkinggau mayan	coast
hpun palawng	coat
ntsa palawng	coat
kaw hpi	coffee
shingran myit	cognitive
mu chye ai lam	cognitive
ang sha a re ai	coincidence
kashung ai	cold
katsi ai	cold
waw	cold
kazut taw ai	collapse
malap galau mat ai	collapse
kabawp taw ai	collapse
lawng du	collar
kaw lan	collar
mu gun manang	colleague
bungli rau galaw manang ni	colleagues
mahkawng tawn ai	collect
lahkawn la ai	collect
shing gyin la ai	collect
mahkawng da ai rai	collection
hkawlik	college
nsam	color
nsam	colour
nlung shadaw	column
shadaw daw hpum	column
pasi	comb
u jaw ban	comb
gumhpawn ai	combination
matut ai	combination
pawng ai	combine
gumhpawn ai	combine
matut ai	combine
sa wa ai	come
sa wa u	come
ndai kaw sa wa rit	come here
sa wa rit	come on
grai	come on
shalan shabran ai	comfort
myit shabran ya ai	comfort
manu ai	comfortable
du wa ra ai	coming
sa wa sai	coming
kade nna yang sa wa na	coming soon
hkang da ai	command
hpaji jaw ai lam	comment
matsun madun ga	comment
hpaga masa	commercial
komishin gumhpraw , komishin hpung	commission
shut hpyit ai	commit
tawt lai ai	commit
ga sadi jaw da sai bungli	commitment
mara yin la ai	committed
hpaga rai	commodity
gun rai	commodity
law malawng	common
matut mahkai ai	communicate
matut mahkai lam	communication
hpung	community
galai hkat ai	commute
ari jaw ai lam hpe shayawm kau ya ai	commute
manang	companion
manaw manang	companion
hpaga hpung	company
shing daw ai	compare
shingdaw ai lam	comparison
matsan dum myit	compassion
matsan dum chye ai myit	compassionate
htap htuk ai	compatible
hkrak ai	compatible
htuk ai	compatible
shing jawng ai	compete
kung gat ai	competent
lawan ai	competent
zen ai	competent
shingjawng poi	competition
shingjawng ai lam	competition
shing jawng ai lam	competitive
put ai	complain
lajin laroi ga	complaint
lachyum shatsup ya ai ga	complement
jahkrum ya ai	complement
hkum tsup sai	complete
jahkum ai	complete
shatusp ai	complete
shangut shakre hkra	completely
jahkum shatsup hkra	completely
jashuk ai rai	complex
hpran la yak ai	complex
chye na yak ai	complex
hkan nang hkan sa ai lam	compliance
shuk ai	complicated
yak ai	complicated
shakawn shagrau ai	compliment
shakawn shagrau lam	compliment
myit ra hkan ya ai	comply
tsun ai hku hkan galaw ya ai	comply
gin shalat da ai	composition
wang	compound
tsi gayau ai	compound
chye na hkawn hkrang lu ai atsam	comprehension
myit hprang ai	comprehensive
dum hprang ai	comprehensive
jahkrup daw dan ai	compromise
n galaw n mai	compulsory
hkrak tup	compulsory
kumpyuta	computer
myit lawm hkra galaw ai	concentrate
kahkyin ai	concentrate
myit maju jung ai	concentrate
hkam la lam	concept
ningmu	concept
myit pu ba ai	concern
seng ang ai	concern
seng ai	concerned
myit hpawm lam	concert
kawn set madun poi	concert
daw dan lam	conclusion
tup hkrak re ai	concrete
dan dan leng leng re ai	concrete
atawng apa	concrete
masa	condition
masa ni	conditions
galaw ai	conduct
mungbawng zuphpawng	conference
bawngban zuphpawng	conference
yin la ai	confess
gwi ai	confidence
kam ai	confident
gwi ai	confident
shagrin ai	confirm
manghkang	conflict
myit hkanu shangun ai	confused
myit shuk hkun ai	confused
kashuk kashak	confusion
sheng mawng sheng hkang	confusion
kabu aw law ai	congrats
kabu aw law ai lam	congratulation
grai kabu lawm sai	congratulations
grai arawng la ai	congratulations
ga matut	conjunction
matut mahkai ai	connect
matut ai	connect
awng padang ninglaw lu ai	conquer
dang kau ai	conquer
maja taw ai	conscious
sadi maja ai	conscious
dumhprang ai	consciousness
myit hta hprang ai	consciousness
shagrau sha a ai	consent
aw law ai	consent
akyu ara hku n na	consequences
de a majaw	consequences
sin la jang da ai lam	conservation
kyem mazing da ai lam	conservation
mungding myu tsaw myit	conservative
mungding myu tsaw myit rawng ai	conservative
Myit shalawm ya ai	consider
myit ya ai	consider
myit ya ai	considered
myit shalawm ya ai	considered
shang lawm ai	consist
lawm ai	consist
galai shai ai lam n nga ai	consistency
dinggrin nga taw ai	consistent
kang ai	constant
kang kang ka ka	constantly
ga sadi dung let	constantly
kan chyat machyi ai	constipation
shachyaw ai	construction
sha kau ai	consume
jahtum kau ai	consume
akyu jashawn ai	consumption
jai lang ai	consumption
matut mahkai ai	contact
matut ai	contact
kap chye ai (ana)	contagious
lawm ai	contain
shawng lawm ai	contain
rawng ai	contains
shang ai	contains
lawm. ai	contains
ban bung masha	contemporary
prat bung masha	contemporary
matsat kau ai	contempt
n gawn n sawn re ai lam	contempt
nkaw nlaw	contempt
malawm	content
ndang kalang hkat ai	contest
shing jawng ai	contest
ga hkrang matut masa	context
dan	continent
matut manoi	continue
matut ai	continue
shagyin kau ai	contract
nbung ai lam	contrast
maga mi de	contrast
bang lawm ai	contribute
shang lawm ai	contribute
bang lawm ai	contribution
shang lawm ai	contribution
hkang ai	control
dara hkat ra na zawn re ai	controversial
manu ai lam	convenience
htap htuk ai lam	convenience
loi ai lam	convenience
manu ai	convenient
mung jahta ga	conversation
hpung kayin ai	convert
galai ai	convert
galai hkra galaw ai	convert
shalai ya ai	convey
tsun dan ai	convey
myit hkut ai	convince
myit sharawng ya ai	convinced
chye na ya ai	convinced
shadu ai	cook
kachyawng taw ai	cooking
shadu taw ai	cooking
hkrak ai	cool
katsi ai	cool
shakawp ai	cool
myit pawn galaw ai lam	cooperation
jawm galaw ai lam	cooperation
hparan hpareng ai	cope
dang di lu ai	cope
magri hkyeng	copper
pawng	core
hkai nu	corn
n-gawng	corn
jut	corner
shading ai	correct
sharai ai	correct
jaw ai	correct
jahpu manu hkrat ai	cost
hking	costume
bu hpun palawng hking	costume
ginsum kasha	cottage
pasi	cotton
lagyim taw ai	couch
kyem makoi taw ai	couch
jahkru ai	cough
dang di ai	could
dang di na re	could
mung bawng salang hpung kawngsi	council
shagu	count
hti ai	count
gumhpraw jaw pinra	counter
ninghkap gasat ai	counter
mungdan	country
mare buga	countryside
run	couple
chyauhpa	courage
lak jat	course
tara rung	court
sumnung lai	courtesy
sumnung masa	courtesy
kahpu kanau	cousin
makawp ai	cover
jahpun ai	cover
magap ai	cover
dumsu kanu	cow
hkrit ai wa	coward
chyahkrit mai dung	coward
lum ai	cozy
chyahkan	crab
kap ran ga ai	crack
ga ai	crack
lata hpaji	craft
hka li	craft
hki hkaw ai	crap
akrawp shara ai nsen	crash
agrawp daw ai	crash
nachying sharawng ai	craving
mak ai	craving
gumrawt hkawm ai	crawl
wa hkawm hkawm ai	crawl
mana	crazy
shachyaw ai	create
hpan ai	create
sawn shapraw chye ai	creative
shakawn shagrau ai	credit
hkoi shap ai gumhpraw	credit
gumrawt hkawm ai	creep
wa hkawm hkawm ai	creep
kashung si pru na zawn re	creepy
hkrit hpa	creepy
bungli galaw masha	crew
ru hka amu	crime
Myiman tam ai	cringe
manghkang	crisis
mara tam ai	critical
si hkrung si htan	critical
ahkyak ai	critical
dinglum ai	criticism
rang rip ai lam	criticism
abrut sha ai	crop
hkai nmai	crop
nsi nai si	crop
hkai n mai ni	crops
nsi nai si ni	crops
udang	cross
hkap ai	cross
u hka	crow
u goi ai	crow
shara hpawng	crowd
tap ai	crowded
jan mau	crown
ahkrak dik ai	crucial
si hkrung si htan	crucial
n hkru ai	cruel
matse ai	cruel
sanghpaw hte du sa hkawm chyai ai lam	cruise
rin ai	crush
hkrap ai	cry
kumgyin si	cucumber
ahpum ai	cuddle
ginshum ai	cuddle
htunghking	culture
akyang n kaja ai	cunning
zai rawng ai	cunning
hkalem sha chye ai	cunning
gawm	cup
wan seng gawm	cup
sumhtang	cupboard
sumpu	cupboard
shading kau ai	curb
gumra n gup gyit sumri	curb
shamai ai	cure
shana nmai pru matsun	curfew
sharawng myit	curiosity
chye mayu myit	curiosity
myit shang sha ai	curious
shinglet galu ai	curious
magi da ai	curly
gumhpraw	currency
ya	current
ya	currently
ndai laman	currently
matsa mawa ga	curse
pan grang	curtain
nbung lahkum	cushion
u mun	cushion
lai len	custom
lai	custom
htunghking	custom
Gunrai mari ai wa	customer
htung hking	customs
lai masa	customs
htung masa	customs
gadoi ai	cut
akrit ai	cut
di ai	cut
kaw lakai	cute
shing wang	cycle
lagaw leng	cycle
lagaw leng jawn ai	cycling
awa	dad
awa	daddy
shani shagu	daily
matsing laika buk	dairy
nga chyu shup shara	dairy
ngachyu shadu shara	dairy
madim	dam
za ai	damage
hten za ai	damage
bam ai	damp
nyaw ai	damp
madi ai	damp
ka manawt ai	dance
hkrit tsang ra ai lam	danger
hkrit hpa	danger
hkrit tsang hpa	dangerous
chyang ai	dark
sin ai	dark
tsaw	darling
maja gat ai	dash
ga matut	dash
ga shaw	dash
jahpan lawk	data
jahpan	data
jahpan hkrang	data
nhtoi	date
kasha numsha	daughter
shani	day
si ai	dead
ngut nan ngut ra ai ten	deadline
na layawng ai	deaf
na hpang ai	deaf
myit hkrum ai	deal
Hkawp myitsu	dear
Tsawra hkungga ai	dear
tsawra hkungga ai yawng hpang de	Dear All
Tsawra ai gunrai mari ai wa e	Dear Customer
Tsawra ai  nu yen wa	Dear Parents
Tsawra ai sara	Dear Sir
Tsawra ai jawngma ni	Dear students
Tsawra ai hpung masha ni	Dear Team
si ai	death
mungga majan	debate
ga tsun shingjawng poi	debate
jaw ra ai hka gumhpraw	debit
hting mut	debris
chya hten	debris
gumhpraw hka	debt
hka	debt
shi ning ladaw	decade
tsam ai	decay
yet mat ai	decay
nyawp ai	decay
si mat ai	deceased
hka lem sha ai	deceive
maga ta	december
arawng lu ai	decent
daw dan ai	decide
daw dan ai	decided
daw dan ai lam	decision
mawn shatsawm tawn ai	deck
magap ai	deck
ninghkap ai	decline
shagrit kau ai	decrease
yawm mat ai	decrease
rang da ai	dedicated
ap nawng da ai	dedicated
ap nawng ya ai lam	dedication
san san ap nawng ya ai lam	dedication
lai nsam	deed
sat lawat	deed
ga sadi laika	deed
sung ai	deep
chyahkyi	deer
hprai ai	default
sum ai lam	defeat
hkrat sum ai	defeat
makawp maga ai	defend
hkap makawp ai	defend
masat da ai lam	define
ga lachyum masat da ai	define
hkrak tup	definitely
lachyum hpyen ai	definition
madang	degree
hpang hkrat ai	delay
kanung ai	delay
shana tawn ai	delayed
hting nai ai	delayed
jahkring tawn ai	delayed
shaprai kau ai	delete
sharam yu ai	deliberate
atsawm sha myit yu ai	deliberate
grai sadi jahtuk ra ai	delicate
anai anya re ai	delicate
mu ai	delicious
nam chyim rawng ai	delicious
kabu pyaw ai	delight
sharawng awng lam	delight
kabu pyaw ai	delighted
sharawng awng lam	delighted
hkrang shaw la ai	deliver
sai shaw la ai	deliver
sa ya ai wa	deliver
hkrang shaw da sai	delivered
sai shaw la da ai	delivered
ap ya ai	delivery
jaw ya ai	delivery
shawk shawn ai	demand
hpyi shawn ai	demand
hpyi la ai	demanding
hpyi shawn taw ai	demanding
mung shawa a dat kasa ni uphkang masa	democracy
awngdawm ai	democracy
nat	demon
nat matse	demon
galaw madun da ai	demonstrate
n-gun madun dan ai	demonstrate
ningdang kau ai	denied
nyet kau ai	denied
numhtat	density
wa sarawun	dentist
wa tsi du	dentist
nyet ai	deny
ninghkap ai	deny
ginwang	department
bungli dap	department
pru wa ai	departure
rawt ai	departure
shamyet shanat ai	depend
kamhpa ai	depend
machyu ai	depend
hpyen la ni hpe shabra tawn ai	deploy
bang ai	deposit
myit hten ai	depressed
lagyawk ai	depressed
myit daw ai	depression
sung de	depth
ningsung	depth
hpaw madun ai	describe
sanglang dan ai lam	description
htak mat ai	desert
hprawng hkawm mat ai	desert
ging dan ai	deserve
maka	design
aya	designation
shatsam da ai	designation
ra sharawng ai	desire
ra marit ai	desire
saboi	desk
myit htum shara	despair
gawng run shara	despair
myit mada shara n nga ai	desperate
raitim mung	despite
pan dung	destination
gam maka	destiny
pandung	destiny
jahten ai	destroy
sharun jahten amu	destruction
hten byak lam	destruction
akri akrai	detail
akri akrai	details
sawk tam la lu ai	detect
myit daw dan ai	determination
myit ja ai	determination
dawdan ai	determine
shatawng	determine
daw dan ai	determined
hten run mat shangun ai	devastated
agrawp daw kau ai	devastated
rawt jat wa ai	develop
galu kaba wa ai	develop
bawng ring wa ai	developed
bawng ring lam	development
laknat	device
sa wa nat	devil
nat	devil
myit masin hte ap nawng nna galaw ai	devoted
ga sadi tawn ai	devoted
Dhivehi	Dhivehi
jit dwi ana	diabetes
kan hkaw ana	diarrhea
kan mase ana	diarrhea
shani shagu matsing laika	diary
ga htai chyam	dictionary
galaw ai	did
si ai	die
si ai	died
lusha koi ai	diet
nbung ai lam	difference
shai ai lam	difference
shai ai	different
n bung ai	different
jam jau ai	difficult
yak hkak ai	difficult
htu ai	dig
shari	dignity
arawng ya	dignity
htauli htaula myit ai lam	diligent
shakut shaja ai lam	diligent
shana shat	dinner
kaprup bang ai	dip
dip shalup ai	dip
dip bang ai	dip
ading tawk	direct
matsun madun ai	direct
baw yawng ai	direction
matsun madun ai lam	direction
matsun du	director
matsun madun ai wa	director
matsat shabat re ai	dirt
maza mala re ai	dirt
shanut shana ai	dirt
chyamut chyamat	dirty
abut abye	dirty
agang chyalang	dirty
galaw na yak ai	disable
n lu galaw ai	disable
n kung n byen ai	disabled
mat mat ai	disappear
myit hten ai	disappointed
myit daw ai	disappointed
tsin yam tsin dam	disaster
raw di kau ai	discard
kabai kau ai	discard
shapraw kau ai	discharge
gunrai jahkrat ai	discharge
rip kawp tara	discipline
manu shayawm ya ai	discount
sawk tam lu ai	discover
ginghka ai lam	discrimination
bawng ban ai	discuss
jahkrup ai	discuss
hkrum zup bawng ban ai lam	discussion
ana	disease
ana	diseases
makoi  magap da ai	disguise
madawn mayu ai	disgusting
matsat shabat	disgusting
si mai wan	dish
si mai	dish
shat ban	dishes
lu sha ban	dishes
dawm kau ai	dismiss
jahkring kau ai	dismiss
sat kau ai	dispatch
lawan shagun jaw ai	dispatch
hpaw hpren dan ai	display
madun ai	display
tang ai	display
gun ra lajang lam	disposal
hparan lajang lam	disposal
dara ai	dispute
tsan gang lam	distance
ginwang	distinct
garen ginghka ai	distinguish
n ni nkri	distress
myit ru myit yang	distress
gam ya ai	distribution
gam jaw ai	distribution
ginwang	district
shuk ya ai	disturb
nam hkawng	ditch
hka hkawng	ditch
hka hpung lip ai	dive
hka shang ai	dive
shai ai	diverse
kaga ga re ai	diverse
myu hpan	diversity
gam garan ai	divide
garan kachyan ai	divide
Karai Kasang hte seng ai	divine
dinghku hka bra ai lam	divorce
baw sin ai	dizzy
baw kayin ai	dizzy
galaw u	do
di u	do
nang gaw	do you
Nang ngai hpe tsawra ai i?	do you love me
sarawun	doctor
tsi du	doctor
tsi ninghkring	doctor
ga shaka laika	document
di ai	does
n re ai	doesn't
n galaw ai	doesn't
gwi	dog
Dogri	Dogri
galaw taw ai	doing
ma sumla	doll
sumla	doll
uphkang ginwang	domain
dinghku kata	domestic
grau ai	dominant
ka up tawn ai	dominant
hkum	don't
hkum tsang	Don't worry
alu jaw ai	donate
gam jaw ai	donate
ngut mat sai	done
galaw ngut sai	done
masha sabuk	donkey
gumra	donkey
lawze	donkey
yup tsi	dope
nang hpan tsi mawan	dope
htam lahkawng	double
n tsen ai	doubt
gumhpraw	dough
hkrat ai	down
lawu	down
hkrang shapraw ai lam	draft
gang la ai	drag
garawt ai	drag
lwi taw ai	drain
hkaw taw ai	drain
zat madun ai lam	drama
maumwi madun ai lam	drama
soi ai	draw
baw	draw
saboi shinglet	drawer
sumla soi taw ai	drawing
hkrit kajawng ai	dread
shingran	dream
myit mada lam	dream
yup mang	dream
bu hpun ai	dress
sum raw ai	dress
bu hpun palawng	dress
shaman shakyang ai	drill
hpyen sharing ai	drill
lu ai	drink
lu hpa	drink
gawt ai	drive
hkang ai	drive
gau ai	drive
shalut u	drop
di hkrat ai	drop
kahte kapya ai	dropped
jahkrat kau ai	dropped
tat jahkrat kau ai	dropped
chyahkraw chyagan byin ai lam	drought
jan gri ai lam	drought
tsa bam ai	drunk
tsa bri ai	drunk
hkraw ai	dry
hkai pyek	duck
a majaw	due
de a majaw	due to
a nya	dull
ma a	dumb
mau ai	dumb
nyaw	dump
aten ladaw	duration
laman	during
n hpu	dust
ahpu kau ai	dust
lit	duty
hkan dawk	duty
shanu nga ai	dwell
nga ai	dwell
si hkyen hkyen rai taw ai	dying
langai hpra	each
langai hte langai	each other
masin rawt ai	eager
galang	eagle
na	ear
grau jau nna	earlier
jau	early
kahprim	early
lu ai	earn
shang ai	earn
hkap la lu ai	earn
na	ears
mungkan ga	earth
n nang nawn ai	earthquake
aloi sha	ease
loi loi hte sha	easily
a loi sha	easily
sinpraw	east
loi ai	easy
a loi sha	easy
sha ai	eat
sha taw ai	eating
sut lu nga mai lam hte seng ai	economic
sut lu nga mai lam	economy
ningchyan	edge
sharai ai	edit
hpaji	education
akyu	effect
akyu nga ai	effective
nyam ai	effective
n-gun marai	efficiency
masan sa ai	efficient
ram ai	efficient
akyu rawng ai	efficient
shakut shaja ai	effort
u di	egg
saba si	eggplant
saba hpun	eggplant
ngai ngu ai myit	ego
madu a myit	ego
matsat	eight
shi matsat	eighteen
matsat shi	eighty
lahkawng kaw na langai	either
langai nrai yang langai	either
kata lam sang lang dan ai	elaborate
machyang ndum	elbow
salang	elder
du	elder
asak grau kaba ai	elder
asak kaba ai	elderly
hkik hkam ai	elegant
grai grak ai	elegant
npawt rudi rai	element
hkarang jet	element
magwi	elephant
shi langai	eleven
tara shang ai	eligible
dawm kau ai	eliminate
shaw kau ai	eliminate
la kau ai	eliminate
kaga	else
laga	else
gaya ai	embarrassed
gaya kahpa byin ai	embarrassing
hpum ai	embrace
pru ai	emerge
paw pru ai	emerge
byin pru ai	emerge
hkyak hkyak galaw ra ai lam	emergency
myit hkam sha lam hte seng ai	emotional
myit tau la ai lam	empathy
ahkyak shatai ai lam	emphasis
myit shabawn ai	emphasize
ahkrak da ai	emphasize
bungli shangun masha	employee
bungli masha	employee
bungli galaw masha ni	employees
bungli madu	employer
magma bungli	employment
bungli bungsa	employment
kaman	empty
galaw lu ai	enable
hkrum katut ai	encounter
n-gun jaw ai	encourage
shalan ai	encourage
jahtum jahpra kau ai	end
shangut kau ai	end
kre mat sai	end
shoi hpa byin shangun kau ai	endangered
hkrit hpa byin shangun kau ai	endangered
shakut shaja ai lam	endeavor
atsam rawng ai lam	endurance
hkam sharang lu ai atsam	endurance
hkam sharang ai	endure
hkam lu ai	endure
grin nga ai	endure
hpyen wa	enemy
hpyen	enemy
tsam n-gun	energy
mahtan ai	engage
dara ai	engaged
mahtan da ai	engaged
mahtan da ai	engagement
jak	engine
jak gawng	engine
jak sara	engineer
jak ninghkring wa	engineer
Ingalik	English
shatsaw ai	enhance
shajat ai	enhance
pyaw len ai	enjoy
len ai	enjoy
mana maka kaba ai	enormous
grai kaba ai	enormous
ram sai	enough
shateng ai	ensure
shang wa ai	enter
shangwi shapyaw ai lam	entertainment
grai sharawng ai myit	enthusiasm
katu myit	enthusiasm
masin rawt ai	enthusiastic
yawng	entire
kup	entire
gabaw tawn ai	entitled
gabaw shakap ai	entitled
prat	entity
chyinghka lam	entrance
hpaga ga ai wa	entrepreneur
NA laika sumbu	envelope
makau grup yin	environment
manawn masham ai	envy
hkik hkam share shagan ni a sat la wat	epic
lai hte seng ai	epic
zindam	epidemic
li	epidemic
zinli	epidemic
maren re ai	equal
bung ai	equal
maren mara	equal
arung arai ni	equipment
gambum manu	equity
bung ai rai	equivalent
bung ai	equivalent
shaprai tawng	eraser
ga shut	error
shut ai lam	error
lawt kawt ai	escape
lawt lu ai	escape
tawt lai lu ai	escape
madung hku na gaw	especially
grau n na	especially
laika galu	essay
akri namta	essence
machyim namta	essence
laidung	essence
n nga n mai	essential
gaw de ai	establish
hpaw ninghtan ai	establish
galaw hpang ai	established
hpaw ninghtan ai	established
madu lamu ga	estate
lamu ga	estate
shadu ai	estimate
htang ai	estimate
sawn sang yu ai	estimated
tau sawn yu ai	estimated
agrin nga ai	eternal
htani htana re ai	eternal
arawn alai	ethics
manu masat ai	evaluate
daw dan ai	evaluate
sawn dik lik yu ai	evaluate
manu masat ai	evaluation
daw dan ai	evaluation
bai dinglik yu ai lam	evaluation
pyi	even
mung	even
raitim mung	even though
shana daw	evening
lamang	event
jahtum e	eventually
galoi mung	ever
ayen na	ever
yawng	every
n lang	everybody
masha shagu	everybody
hkum ngau shagu	everyone
yawng	everyone
yawng	everything
sakse	evidence
aru ara	evil
sinda masa	evolution
yat yat byin kunghpan wa ai masa	evolution
galai shai wa ai	evolve
rawt jat wa ai	evolve
Ewe	Ewe
moi na	ex
dingsa	ex
hkrak tup	exact
teng sha	exactly
hkrak	exactly
san poi	exam
gawn jep yu ai	examine
sanjep yu ai	examine
ga shadawn	example
kamang	example
kasi	example
shajan ai	exceed
dinglai ai	exceed
hkrak dik sai	excellent
ninghkring	excellent
hta lai nna	except
ga hpunda	exception
shajan shalai re ai	excess
shalai chying hkai	excess
shajan shalai re ai	excessive
galai	exchange
myit kahpra ai	excited
kajawng ai	excited
ndawt myit	excitement
katu myit	excitement
myit kahpra ai	exciting
kajawng ai	exciting
manu hpu reng ai	exclusive
lak san re ai arai	exclusive
alak mi galaw da ai	exclusive
lawt ga	excuse
chyeju hte	excuse me
shabyin dat ai	execute
gun hpai ai	execute
gun hpai ai lam	execution
shabyin dat ai lam	execution
uphkang magam	executive
shamu shamawt lam	exercise
dat nsa pru ai lam	exhaust
pu mat ai	exhaust
ba kahpau ai	exhaust
pu ba ai	exhausted
hki ba ai	exhausted
madun dan ai	exhibit
sakse rai	exhibit
madun gawk	exhibition
pra ai	exist
nga ai	exist
nga pra lam	existence
prat	existence
asak hkrung ai	existing
nga pra ai	existing
chyinghka lam	exit
pru lam	exit
gahpyen ai	expand
maden jat la ai	expand
jat la ai	expand
myit mada ai	expect
myit mada da ai	expected
htum jarik	expenses
htum gumhpraw	expenses
laja ai	expensive
hpu ai	expensive
mahkrum madup	experience
chyam dinglik yu ai bungli	experiment
grai ningtawn ai wa	expert
masat da ai aten lai mat sai	expired
sang lang dan ai	explain
shaleng dan ai	explain
shaleng dan ai lam	explanation
kanoi sha ai	exploit
n-gun makru daw sha ai	exploit
sawk sagawn ai	explore
sawk tam ai	explore
shapraw gun rai	export
kra tawn ai	expose
tsun dan ai	expose
madun da ai	expose
kra tawn ai	exposed
tsun dan ai	exposed
madun dan ai	exposed
hpaw dan ai lam	exposure
shabrawng dat ai lam	exposure
madun dan ai	express
hpaw hpran dan ai	express
hpaw madun ai	expression
myi man nsam	expression
sharen ai	extend
maden ai	extend
maden jat la da ai	extended
lata ladawn da ai	extended
ap ya ai lam	extension
jat la ai	extension
shadawn jarik	extent
shinggan na	external
myit wa ai	extinct
htum wa ai	extinct
shajan	extra
alak mi re ai	extra
baw kau ai	extract
shaw la kau ai	extract
lak lai ai	extraordinary
nchyan	extreme
ladu shalai	extreme
matu	extreme
ladu lai	extremely
grai nan	extremely
myi	eye
myi	eyes
ri da sumpan	fabric
kam na yak ai	fabulous
mau hpa re ai	fabulous
myiman	face
loi shangun ai	facilitate
arai	facilities
madi shadaw rai	facility
shaloi ya ai lam	facility
jaw ai lam	fact
mabyin	fact
masa lam byin ningpawt lam	factor
jak rung	factory
bungli dap	factory
sumhpa lam	facts
ga lami	facts
lai masa	facts
nyip mat ai	fade
wai mat ai	fade
hkoi mat ai	fade
hkrat sum ai	fail
sum ai	fail
hkrat sum mat ai	failed
gin lut ai	failure
hkrat sum ai	failure
malap mat ai	faint
rapra ai	fair
ram daw	fair
rap rap ra ra	fairly
nat shayi	fairy
kam sham ai	faith
kang ka ai	faithful
htep lahti re ai	faithful
kam sham ai	faithful
n teng ai	fake
hkrat ai	fall
di hkrat ai	fall
shut ai	false
gumhkawng ai lam	fame
sadang hkung ai lam	fame
mawn hkat ai lam	familiar
hkau chye hkat ai lam	familiar
dinghku	family
hku hpyen	famine
mying kaba ai	famous
mying gumhkawng ai	famous
layit	fan
myit nawn ai	fancy
zawn nawn ai	fancy
grai hkrak ai	fantastic
mau na zawn re ai	fantastic
tsan ai	far
shakram poi	farewell
sun	farm
yi sun galaw ai	farm
hkauna la	farmer
hkauna galaw ai wa	farmer
yu ra shingni	fascinating
hking	fashion
gyin shapraw ai	fashion
mawn sumli masa	fashion
lawan ai	fast
gam	fast
hpum ai	fat
si chye ai	fatal
si wa shangun lu ai	fatal
gying ai	fate
gam maka	fate
awa	father
aba shala	fatigue
shut shai ai	fault
ra sharawng ai	favorite
myiman pa lam	favour
ningshawng jaw ai lam	favour
lama ma hpe ra ai	favourite
hkrit ai	fear
lu sha poi	feast
poi n htoi	feast
u mun	feather
myi man nsam	feature
lak lai ai	feature
hkrang nsam	feature
ra ta	february
myit hten ai	fed up
myit htum ai	fed up
manu jahpu	fee
yaw	feed
jaw sha ai	feed
jaw ai	feed
mahtai tang	feedback
hpaji jaw ga	feedback
hkam sha ai	feel
myit hkam sha lam	feeling
lagaw	feet
lut	fell
hkrat ai	fell
la wa ngan	fellow
manang hpaji ningtawn hpung shang wa ai	fellow
hkam sha ai	felt
Num	female
bunghku	fence
nhpan	fence
namhpun	fertile
namhpun dat ai	fertile
poi	festival
poi shingra	festival
sa la wa ai	fetch
la wa ai	fetch
kahtet ai	fever
kaji mi	few
kachyi	few
grau yawm ai	fewer
grau shau ai	fewer
mahtan da ai la	fiance
mahtan da ai num	fiance
sumroi laika	fiction
maumwi	fiction
Hkai sun	field
dap	field
Sun	field
matse	fierce
shi manga	fifteen
manga shi	fifty
kasat ai	fight
daru ai	fight
yaw ai	fight
gasat hkat ai	fighting
htawng hkat ai	fighting
hkrang	figure
hkrang sumla shapraw ai	figure out
zet sang	file
laika nhtan	file
jahpring ai	fill
kaput bang da ai	filled
ru bang da ai	filled
jahpring da ai	filled
sumla hpalin	film
hpalin sumri	film
matsat shabat re ai	filthy
agang chyalang re ai	filthy
hpang jahtum	finally
jahtum e	finally
sut gumhpraw lam	finance
gumhpraw hte seng ai lam	financial
sut hte seng ai lam	financial
mu ai	find
mu tam ai	find
mu lu ai	find out
tam sawk gawn lu ai	find out
Kaja sai	fine
Mai kaja sai	fine
Hkrak sai	fine
lata latsang	finger
layung	finger
jahpra kau ai	finish
shangut kau ai	finish
sha ngut kau ai	finished
sha kre kau ai	finished
wan	fire
shakang u	firm
shangang u	firm
shawng ningnan	first
magang	first
shawng na mying	first name
nga	fish
hkrup	fit
htuk manu ai	fit
htap htuk ai	fit
manga	five
byeng ai	fix
me ai	fix
masat	fix
masat da ai	fixed
dawng hkawn	flag
kaprip ai	flash
galam ai	flash
kaprap ai	flash
pyet ai	flat
ningma	flaw
mara	flaw
ra n rawng ai	flawless
nrawng ai	flawless
mara nkap ai	flawless
hpawng mat wa ai	flee
hkum shan myit	flesh
shan	flesh
lwi hkrat mat ai	flew
kapya mat ai	flew
gumba mai ai	flexible
kam ai hku galaw mai ai	flexible
nbungli	flight
nbungli jawn shapyaw hkawm ai	flip
myit gin sup ai	flirt
myi man law ai	flirt
myit gin sup ai lam	flirting
waw ai	float
shayawng ai	float
hka kanawng ai	flood
hka lung ai	flood
maw ru ru ai	flood
ga	floor
kadung	flour
hpaw ai	flow
yawng ai	flow
nampan	flower
mak hkalawng	flu
ga balen rawng ai	fluent
ga ningtam rawng ai	fluent
ga balen rawng ai	fluently
ga ningram rawng ai	fluently
tu wa ai	fluffy
u mun hkalung	fluffy
lwi hkawm chye ai baw	fluid
n grin ai	fluid
pyen ai	fly
jinu	fly
myit mang shabawn ai	focus
sai wan	fog
mu hkup	fog
mu hkup mawng ai	foggy
saiwan mawng ai	foggy
gumba ai	fold
kapum mat ai	fold
masha amyu	folks
masha	folks
hkan nang ai	follow
hkan sa ai	follow
matut galaw ai lam	follow up
matut sawk ai lam	follow up
hkan nang ai	following
npu na	following
lusha	food
mana ai	fool
a ngawk ai	foolish
sa ngawk ai	foolish
mana ai	foolish
lagaw	foot
gaw din	football
a matu	for
ga shadawn	For example
ga shadawn nga yang	for instance
Nang na matu	for you
pat shingdang da ai	forbidden
n-gun	force
maram masam yu ai	forecast
ka htan	forehead
maigan	foreign
nam maling	forest
maling dinggram	forest
prat tup	forever
malap ai	forget
mara dat ya ai	forgive
malap kau ai	forgot
kabrang	fork
kabra	fork
hkrang	form
masa tara hte seng ai	formal
htung tara hte seng ai	formal
chyaloi	former
gam rawng let	fortunately
gam a kaja sha	fortunately
gam	fortune
gam maka	fortune
mali shi	forty
mali shi lahkawng	forty-two
shawng lam	forward
shawng de	forward
mashawn	forward
bau la ai	foster
gasat hkat ai	fought
mu ai	found
madung	foundation
npawt ru di	foundation
daipawt daihpang	foundation
mali	four
shi mali	fourteen
chyahkyawn	fox
kya ai	fragile
akya	fragile
hkrang galaw ai	frame
hkrang masat	frame
hkrang	framework
shamawp ai	fraud
map ai	fraud
mana	freak
shang lawt ai	free
dat dat ai	free
awm dawm	freedom
sha ge ai	freeze
ge ai	freeze
lang masat	frequency
ya sha ya sha re ai	frequent
loi hkring hkring	frequent
yasha yasha	frequently
jahkring hkring	frequently
katsing galang	fresh
a kahtet hpoi hpoi sha	fresh
myit asan nga ai	fresh
bat manga ya shani	friday
hpan shani	friday
manang	friend
hkau ai	friendly
chyap ai	friendly
manang ni	friends
manaw manang ni	friends
hku hkau ai lam	friendship
hkau chyap ai lam	friendship
hkrit gari ai	frightened
kajawng kaja byin ai	frightened
jahkrit taw ai	frightening
shu	frog
kaw nna	from
hta	from
kaw	from
shawng lam	front
shawng de	front
ge mat ai	frozen
namsi namsaw	fruit
shamat kau ya ai	frustrated
dingbai dingla jaw ai	frustrated
jahten kau ya ai	frustrated
wan hpun	fuel
sau	fuel
wan n shat	fuel
Fulfulde	Fulfulde
hpring ai	full
hpring tup re ai	full
pyaw hpa	fun
mani hpa	fun
bungli byin ai	function
rudi n pawt	fundamental
moi mang makoi mayang lam	funeral
mani hpa	funny
malat mun	fur
grai pawt ai	furious
hking hku	furniture
arung arai	furniture
n ga	further
hta lai n na	further
tsan dik htum	further
grau nna	furthermore
shawng lam	future
jat wa ai	gain
lu la ai	gain
amyat	gain
ginsup hpa	game
mahka ai shara	gap
gang ai	gap
mawdaw nta tawn shara	garage
shanut shanaw	garbage
maza	garbage
sun	garden
shakau hpraw	garlic
wang chyinghka	gate
lahkrip ra ra	gather
rau sha	gather
hkrum zup hpawng	gathering
hpawng shing ra	gathering
shadawn ai	gauge
jaw ya ai	gave
lailen	gender
hkrang	gender
ra mara	general
ninggawn masa hku nna	generally
jak kri taw ai	generate
shapraw ai	generate
ban	generation
gam jaw chye ai	generous
hpaji ninghkring	genius
sumnung shingdi ai	gentle
jet ai	genuine
shamawt	gesture
lai kumla	gesture
lu la ai	get
bu hpum sumraw u	get dressed
tsap ai	get up
yup rawt ai	get up
rawt ai	get up
lawan mai tsai wa u ga yaw	get well soon
sana	getting
tsu	ghost
min la	ghost
nat hkrang madun ai	ghosting
masha numraw	giant
grai kaba ai	giant
kumhpa	gift
shanam	ginger
num kasha	girl
sumtsaw	girlfriend
numsha manang	girlfriend
ya ai	give
jaw ai	give
asum jaw ai	give up
jaw da ai	given
jaw da sai	given
kabu ai	glad
praw di ai	glance
pat	glass
mi set	glasses
pram di mu ai	glimpse
chyahkring sha mu ai rai	glimpse
mungkan chyam hkra	global
myit kaji ai	gloomy
myit nchyi nmu ai	gloomy
lata larawp	gloves
htoi ala ai	glow
htoi akung ai	glow
htoi tu u	glow up
nga rung gyep kap	glue
naw	glue
Sa su	go
sa ai	go
Sa u	go
matut tsun u	go ahead
shawng shawng u	go ahead
tsan tsan de sa u	go away
tsan e nga u	go away
Yup ra shang sana	go to bed
bandung	goal
yaw shada lam	goals
bandung	goals
bai nam	goat
Karai Kasang	god
Karai Kasang shaman ya u ga	god bless you
sa ai	goes
byin ai	goes
sa taw ai	going
sana	going to
galaw sana	going to
ja	gold
mat mat sai	gone
sa mat sai	gone
di na ra ai	gonna
byin na ra ai	gonna
nya nya re ai	goo
Kaja sai	good
Alu ai shani.	good afternoon
shakram dat ai	good bye
shani kaja rai u ga	good day
Alu ai shana rai u ga	good evening
mai kaja sai	good job
yu tsawm taw nga ai	good looking
yu htuk taw nga ai	good looking
gam kaja u ga	good luck
A lu ai jahpawt	good morning
Alu ai jahpawt rai u ga yaw tsawra	good morning my love
Dai ten laman	good night
Aten hta	good night
Aten e	good night
shakram dat ai	goodbye
a lu ai shana	goodnight
arai	goods
kun rai	goods
Google laika gale ai	Google Translate
Google ga gale ai	Google Translate
masha shabu	goose
shangma	goose
Grai tsawm ai	gorgeous
shatan ai	gossip
tsun gazik ai	gossip
matsun mana ga	gossip
lu ai	got
chye na sai	got it
lu la sai	got it
asuya	government
magra ai	grab
tsang	grade
madang	grade
yet yet sha	gradually
hpaji jan mau gup ai	graduate
hpaji jan mau gup lu ai wa	graduate
tum	grain
nsin	grain
n-gu	grain
shagrau jaw ai	grant
ahkang jaw gumhpraw	grant
shagrau jaw ai	granted
ahkang jaw ai	granted
tsabyi si ni	grapes
magra tawn ai	grasp
tsing	grass
chyeju dum ai	grateful
chyeju dum ai	gratitude
chyeju	gratitude
grai sawng ai	grave
lup sung hku	grave
grai tsang ra ai	grave
kara hpraw nsam	gray
wan hkut nsam	gray
Mai kaja dik sai	great
kaja dik sai	great
lu malun myit	greed
nam mak law hpa ai	greed
lawhpa ai	greedy
tsit ai	green
shakram ai	greet
shakram ga	greeting
shakram ga	greetings
kara hpraw nsam	grey
wan hkut nsam	grey
muk muk re ai	grey
yawn hkyen	grief
ningtsang	grief
rin ai	grind
grang ai	grind
gum nup kau ai	grip
manta chyit di ai	grip
jum tek da ai	grip
gunrai hkum sum hpa dut ai seng	grocery
la nnan	groom
zai ai	gross
n-ga	ground
ga	ground
wu hpung	group
hpung	group
rawt jat wa ai	grow
kaba wa ai	grow
galu kaba masa lam	growth
majoi joi jawp ai	grumpy
Guarani	Guarani
madi shadaw ya ai lam	guarantee
sin langa	guard
bau sin ai	guard
makawp maga ai	guard
tak ai	guess
manam	guest
matsun madun ai lam	guidance
lam woi madun ai lam	guidance
matsun madun ai	guide
woi awn ai	guide
mara lu ai	guilty
masha	guy
jahpoi asawng ai	guy
ginsup dum	gym
ginsup nta	gym
akyang	habit
lai nsam	habit
nga ai shara	habitat
mu lu ai shara	habitat
nga ai	had
marang si	hail
marang si hkrat ai	hail
marawn bawp la ai	hail
kara	hair
daw mi	half
chyen mi	half
gawk nu kaba	hall
shawa hting nu	hall
lata	hand
ta	hand
magra ai	handle
lashum	handle
jum tek ai	handle
shingkang ai	handsome
dau si ai	hang
lam tawn ai	hang
noi tawn ai	hang
majoi nga hkawm ai	hang out
majoi yu hkawm ai	hang out
jahkring jahkra wam hkawm chyai ai	hang out
byin wa ai	happen
byin pru ai	happen
byin wa ai	happened
byin pru ai	happened
pyaw hpa lam	happiness
pyaw ai	happy
Ngwi pyaw ai shangai nhtoi rai u ga	happy birthday
Ngai pyaw ai shangai nhtoi rai u ga yaw	happy birthday to you
ngwi pyaw ai shaning nna rai u ga	happy new year
yak ai	hard
agying agang	hardly
ja ja	hardly
yak yak hkak hkak	hardly
yak ga ai	hardly ever
hkrit tsang hpa	harm
dingbai dingla	harm
tsin yam jaw lu ai	harmful
shoi hpa jaw lu ai	harmful
myit hkrum ai lam	harmony
yu ngwi masa	harmony
nsen rap ra ai lam	harmony
hkara	harsh
n mut ten	harvest
mam dan ten	harvest
nga ai	has
n ju ai	hate
n dawng ai	hate
n yawt ai	hate
Lu ai	have
Nga ai	have
Nhtoi kaja rai u ga	have a good day
Ngwi pyaw ai shani rai u ga	have a nice day
jahpawt shat sha u	have breakfast
pyaw u ga	have fun
Sha ngut sai i?	have you eaten
nga ai	having
sa dan ai lam	hazard
hkrit hpa lam	hazard
n hpu mawng ai	haze
bungshi	haze
Dai wa	he
Shi	he
shi kaw nga ai	he has
shi gaw	he is
baw	head
baw machyi ai	headache
shamai ai	heal
tsi lajang ya ai	healing
shamai shatsai ya ai	healing
shamai ya ai	healing
hkam ja lam	health
hkam kaja ai	healthy
na ai	hear
na lu ai	heard
salum	heart
wan dap	heat
kahtet ai	heat
sumsing mungdan	heaven
li ai	heavy
nak ai	heavy
myit law ai	hectic
bungli grai kyin ai	hectic
tsaw shadang	height
sali dagraw na wa	heir
sali wunli hkam wa	heir
damya mya ai lam	heist
kashun ai lam	heist
jum ai	held
ngarai di	hell
Kaja ai i	Hello
E tsawra	hello dear
E ning, hkam ja ai i	hello how are you
E hkau nang zeng gaw rai nga n ni?	hello how are you doing
lagup	helmet
hpri lagup	helmet
karum ai	help
karum kahtau	help
shingtau chye ai	helpful
garum chye ai	helpful
akyu rawng ai	helpful
dai majaw	hence
shi na	her
dumsu hpung	herd
ndai kaw	here
sali wunli hkam la lu ai	heritage
dawn ai	hesitate
tsang ai	hesitate
E	Hey
Hi, Hkam ja nga ai i?	hi how are you
magap da ai	hidden
makoi da ai	hidden
makoi ai	hide
lagyim ai	hide
hpung sara up hkang masa	hierarchy
tsaw ai	high
shadan dan ai	highlight
shadawng dan ai	highlight
shapraw dan ai	highlight
lam hkawm ai	hike
lagaw lam hkawm ai	hike
bum lung ai	hiking
nachying mani hpa	hilarious
bum	hill
shi hpe	him
la kap n na tsun ai ga	hint
ga machyan	hint
dangkawp	hip
mashi	hips
dang kang	hips
shap ai	hire
shap taw ai	hiring
shaga taw ai	hiring
shi na	his
labau	history
adup ai	hit
hkra ai	hit
Hmmm	Hmm
myit lawm bungli	hobby
ra sharawng bungli	hobby
poi galaw ai	hold
jum	hold
jum da u	hold on
jahkring	hold on
sharang u	hold on
hku	hole
n hkun	hole
ban sa nhtoi	holiday
krawk ai	hollow
nhkun nhkaw	hollow
jahtau marawn ai	hollow
dum nta	home
nta kaw galaw ra ai laika	homework
ding ai	honest
dingman ai	honest
myit madu dingman lam	honestly
asan sha	honestly
Lagat n tsin	Honey
Tsaw	Honey
shagrau ai	honor
sha a ai	honor
magap ya ai rai	hood
baw magap	hood
myek	hook
hkai	hook
chyinghkyi	hook
gumlawt hkawm ai	hop
ka gumlawt ai	hop
myit mada lam	hope
grai myit mada let	hopefully
grai kam kaba let	hopefully
myit mada shara n nga ai	hopeless
nda hpan re ai	horizontal
nda tang re ai	horizontal
rung	horn
hkrit kajawng hpa	horrible
hkrit makren hpa re ai	horrible
hkrit gari ai lam	horror
laring gumra	horse
gumra	horse
tsi rung	hospital
manam daw chye ai lam	hospitality
hkap la ai wa	host
madu	host
ninghtan shai hkat ai	hostile
hpyen tai ai	hostile
jap ai	hot
kahtet ai	hot
manam jarawp	hotel
hkying mum	hour
ahkying	hour
hkying hkum	hours
ahkying	hours
nta	house
dinghku	household
gara hku rai	how
Nang gaw gara hku rai?	how about you
Hkam kaja ai i	how are you
zeng re nga ai i	how are you doing
daini zeng rai nga nni	how are you doing today
Nang dai ni gara hku rai?	how are you today
Nang hpa ni galaw ai rai?	how do you do
gara hku na?	how is
kade ram rai?	how many
kade rai	how much
kade lang rai?	how often
Nang na asak kade rai	how old are you
mani gara hku rai	how was your day
Mana gara hku rai	how was your night
Raitim mung	however
gara hku raitim	however
hting chyai	hub
kasha kawa	hubby
madu wa	hubby
chyit ai	hug
hpum ai	hug
kaba dik ai	huge
shinggyim masha hte seng ai	human
shinggyim masha	human
myit sha gyip	humble
myit shanyem ai	humble
bam ai	humid
madi ai	humid
bam nyap masa	humidity
madi nyap	humidity
latsa	hundred
kaw si ai	hungry
kut ai	hungry
tam ai	hunt
hkwi ai	hunt
shan gap ai	hunt
laru	hurricane
nbung laru kaba	hurricane
lawan ladan	hurry
lawan di u	hurry up
lawan	hurry up
kaprep ai	hurt
machyi ai	hurt
madu wa	husband
ningrum ningtau wa	husband
shawa num	hustle
atik anang gau sha le ai	hustle
sum	hut
yi hkyap	hut
ginsum	hut
hkam kaja lam	hygiene
Ngai	I
ngai gaw	I am
Ngai kaja ai	I am fine
ngai dang di lu ai	I can
ngai n dang di ai	I can't
ngai galaw ai	I do
ngai n chye ai	I do not know
ngai nchye na ai	I do not understand
ngai n re	I don't
Ngai n chye ai	I don't know
Ngai n chye na ai	I don't understand
Nang hpa tsun mayu ai hpe ngai n chye na ai.	I don't understand what you mean
ngai nang hpe n chye na sai	I don't understand you
ngai nchye ai	I dont know
ngai n chye na ai	I dont understand
ngai shadu ai	i guess
ngai htang ai	i guess
ngai kaw nga ga ai	I had
ngai kaw nga ai	I have
ngai galaw hpang wa ai	I have been
Ngai mung myit mada ai	I hope so
Ngai chye ai	I know
ngai ra ai	I like
Ngai nang hpe ra ai	I like you
ngai tsawra ai	I love
Ngai nye hpu ba hpe tsawra ai	I love my big brother
Ngai nye kana hpe tsawra ai	I love my big sister
Ngai nye wa hpe tsawra ai	I love my father
Ngai nye kanau la sha hpe tsawra ai	I love my little brother
Ngai nye kanau numsha hpe tsawra ai	I love my little sister
Ngai nye nu hpe tsawra ai	I love my mother
Nang hpe ngai tsawra ai	I love you
Nang hpe ngai grai tsawra ai	I love you so much
Ngai mung nang hpe tsawra ai	I love you too
ngai tsun mayu ai gaw	I mean
Ngai nang hpe dum ai	I miss you
Nang hpe ngai grai dum ai	I miss you so much
ngai chye na sai	I see
ngai shadu ai	I think
ngai chye na ai	I understand
ngai ra ai	I want
Ngai nang hpe hkrum mayu ai	I want to see you
Ngai nang hpe ra ai	I want you
Ngai gaw	I was
ngai galaw na re	I will
ngai galaw na re	I would be
ngai gaw	I'm
ngai zeng re ai	I'm fine
ngai kaja ai	I'm good
ngai ndai kaw re ai	I'm here
myit n pyaw sai	I'm sorry
ngai tawng ban ai yaw	I'm sorry
hkyen	ice
hka ge	ice
hkyen muk	ice cream
myit mang ai lam	idea
myit masa	idea
kamang	ideal
kasi	ideal
htung hte seng ai	ideal
bung pre ai	identical
masat masa	identify
sawk tam nna tang madun ai	identity
bung pre lam	identity
mana	idiot
bungli n lu ai	idle
lagawn ai	idle
aten majoi shalai ai	idle
lama na	if
koi yen ai	ignore
hkum n pyaw ai	ill
machyi makaw ai	ill
tara n shang ai	illegal
machyi makaw ai	illness
Ilocano	Ilocano
gawk ngu sumla	image
hkrang sumla	image
sasat ai	imagine
myit mang ai	imagine
kalang ta nan	immediate
ya jang jang	immediate
hkyak hkyak	immediate
ya jang jang	immediately
kalang ta	immediately
na chying law ai	immense
na chying kaba ai	immense
byin shangun ai	impact
akyu byin ai	impact
myit n galu ai	impatient
myit katu ai	impatient
n dawt ai	impatient
shabyin shatai ai	implement
jashawn ai	import
jashawn gun rai	import
ahkyak ai	important
ahkun hkanse hta ai	impose
masat la ai	impose
n mai byin ai	impossible
myit chyung mat ai	impress
myit hta chyung mat ai lam	impression
ning mu	impression
htang kaba ai	impressive
rawt jat wa ai	improve
rawt jat wa ai lam	improvement
kata kaw	in
dai kaw	in
kata e	in
hta sha n ga	in addition
kaja ngu yang	In fact
shawng e	in front of
shawng hta	in front of
matu	in order to
byin na matu	in order to
n htap htuk ai	inappropriate
myit sharawng rai	incentive
myit shalen rai	incentive
byin pru chye ai	incident
byin nga masa	incident
lawm ai	include
shalawm ai	including
mung lawm ai	including
shang gumhpaw	income
n manu n mana byin ai	inconvenience
jat ai	increase
rawt jat wa ai	increase
jat wa ai	increased
rawt jat wa ai	increased
mau na zawn re	incredible
manu mana	incredible
kaja sha	indeed
kaja nan	indeed
shanglawt ai	independent
shamyet shanat ai lam n nga ai	independent
gala mung	India
madi madun ai	indicate
htawng madun ai	indicate
mungchying sha hte seng ai	indigenous
dinghkrai	individual
langai hpra	individual
jak rung	industry
marai	industry
bungli	industry
n tawt lai lu ai	inevitable
ma chyangai	infant
ma kaji	infant
ana	infection
yawga kap ai lam	infection
htum ngu n nga	infinity
hti ndang hkra	infinity
bum ai	inflammation
gumbawm	inflation
gumhpraw bawm masa	inflation
kaput ai	influence
tsun dan ai	inform
shiga shana ai	inform
shana ai	inform
shiga	information
gayau bang ai rai	ingredients
sali wunli hkam la ai lam	inheritance
sali wunli da graw ai	inheritance
shawng ningnan	initial
npawt nhpang	initial
shawng ai	initiative
machyi hkrum ai	injured
ning ma	injury
hkra machyi ai	injury
kaw lakai ai	innocent
lak lai rai galaw ai lam	innovation
rai n nan galaw shapraw ai	innovation
san jep ai lam	inquiry
san sagawn ai lam	inquiry
ngawk ai	insane
mana ai	insane
shagri	insect
shingtai sumbra	insect
shim ai ngu n hkam sha ai	insecure
bang ai	insert
shakap ai	insert
matep bang ai	insert
kata	inside
shingran myit	insight
maja galaw ra ai	insist
madung da ai	insist
yupgan	insomnia
yup n pyaw mai ai lam	insomnia
myit katu shangun ai	inspiration
wenyi n-gun	inspiration
atsam jaw ai	inspiration
shatsam ya ai	inspire
wenyi n-gun jaw ai	inspire
bang la ai	install
dung ai	install
ga shadawn	instance
ga shadawn madun ai	instance
kalang ta re ai	instant
a kajawng sha re ai	instant
malai	instead
dai na malai	instead of
na malai	instead of
sharin shaga lam	instructions
matsun ga	instructions
hking hku	instrument
madum sumpyi	instrument
n kaw n law di ai	insult
roi ai	insult
pahkam bungli	insurance
pahkam hkam ai lam	insurance
nan nan re ai	intact
shara n nawt ai	intact
arawng sadang	integrity
kraw hpaji kung ai masha	intellectual
hpaji rawng ai	intelligence
nyan zen ai	intelligence
byin ai	intelligent
nyan marai	intelligent
yaw shada ai	intend
yaw shada ai	intended
kaja wa	intended
teng teng	intended
shajan shalai ai	intense
lapyin ai	intense
yaw shada ai	intention
shada da hting lu hting lai ai	interact
shada da hting lu hting lai ai	interaction
myit shang sha ai	interest
myit shang sha ai	interested
myit shang sha ai	interesting
myit lawm ai	interesting
lapren shang shaga ai	interfere
chying bai re ai	interfere
pran wan na	intermediate
dinghku kata na	internal
mung	internal
kata na	internal
mungdan ga daga hte seng ai	international
bungli sharin hkam ai	internship
ga gale tsun dan ai	interpret
ga gale tsun ya ai wa	interpreter
hkrau tsun ai	interrupt
tsun gin jang ai	interrupt
tsun achyau ai	interrupt
masha san jep ai lam	interview
ga san ga htai	interview
hkau chyap ai	intimate
hku hkau ai	intimate
hku nna	into
de	into
shachyen ai	introduce
shaga ai	introduce
shachyen shaga ai	introduction
langai hkrai nga ai wa	introvert
myihtoi myit	intuition
shi hte shi chye ai myit	intuition
shi hkrai shi chye ai nyan	intuition
tara n shang ai	invalid
n hkam kaja ai wa	invalid
n nan gyin shapraw ai	invent
sawk gyin ai	invent
lu la gun rai jahpan	inventory
jahpan hta ai lam	inventory
arang bang ai	invest
rang ai	invest
ga sawk yu ai	investigate
shiga manaw la ai	investigate
saw shaga ai lam	invitation
saw shaga ai	invite
shaga ai	invite
shang lawm ai	involve
malawm	involved
shang lawm ai	involved
hpri	iron
re ai	is
rai ai	is
zunlawng	island
san san di da ai	isolated
kaga san da ai	isolated
shapraw	issue
lawng lam	issue
shale ai	issues
shapraw ai	issues
Dai	it
dai gaw	it is
dai re ai	it was
dai gaw	it's
Hpa n ra ai	it's ok
hpa n ra ai	It's okay
amyu	item
lamang	item
amyu	items
hpan	items
lamang	items
dai gaw	its
ngai gaw	Im
ntsa palawng	jacket
palawng kaba	jacket
hkyuk htawng	jail
htawng	jail
hkru ta	January
hka yam	jar
yam	jar
shakap	jaw
ga manaw galu ai	jaw
manawn masham	jealous
manawn ai	jealous
nabai	jerk
ja lung seng rai	jewelry
kan bau bungli	job
bungli	job
gat hkawm ai lam	jogging
hkin dun ai	join
shang lawm ai	join
matut ai	join
hkri hkraw	joint
lamyi	joint
mani hpa galaw ai	joke
mani hpa	joke
shiga sawk ai wa	journalist
hkrun lam	journey
kabu aw law ai	joy
tara dara ai	judge
daw dan ai	judge
ntsin	juice
jahku	juice
shi mari ta	july
gumlawt ai	jump
shing tawt ai	jump
sangan ta	june
miwa sanghpaw	junk
ya sha	just
sha di dat yu	just do it
tara rap ra ai lam	justice
teng man ai lam madun ai	justify
Jinghpaw	Kachin
Kalaallisut	Kalaallisut
myit rawt ai	keen
zing ai	keep
kyem ai	keep
matut manoi galaw u	keep it up
yu lajang ai	kept
kyem da ai	kept
mazing da ai	kept
hpun lum di	kettle
zaw si	key
sum saw	key
hkin dit ai	kick
htawng ai	kick
hkalung	kid
bainam kasha	kid
ma kasha	kid
majoi shala chyai ai	kidding
shala ai	kidding
sinde	kidney
ma kasha ni	kids
hkalung ni	kids
sat ai	kill
tsawra matsan dum chye ai	kind
amyu hpan	kind
tsawm ra mi	kinda
matsan dum lama hte	kindly
matsan dum lama chye ai myit	kindness
hkaw hkam	king
manam ai	kiss
pup ai	kiss
shat gawk	kitchen
maisau galang	kite
langji	kite
galang	kite
hkalung	kitten
lanyau kasha	kitten
lahput	knee
chye da ai	knew
nhki	knife
nhtu	knife
share magan	knight
chye ai	know
machye machyang	knowledge
chye ai	known
mying gum hkawng ai	known
Konkani	Konkani
Krio	Krio
madi madun ai	label
bungli masha	labor
magam	labor
magam bungli	labour
bungli galaw ai	labour
n nga ai	lack
gawng kya ai	lack
lakang	ladder
arawng aya lu ai hpaw mi	lady
hpaw mi	lady
tawn ai	laid
mara tawn ai	laid
u di di ai	laid
hka nawng	lake
sagu kasha	lamb
chyahten	lame
wan kawk	lamp
pyen ding	lamp
pa	land
bum maling sumla	landscape
ga	language
aga	language
lahpyen	lap
kahpam ai	lap
kaba ai	large
dam lada ai	large
jahtum	last
grin ai	last
jahtum gaw re raitim n ahkyak ai lam gaw n re	last but not least
amyu mying	last name
hpang hkrat ai	late
ndai laman	lately
hpang daw de	lately
yat	later
hpang e	later
jahtum re ai	latest
dai hpang	latter
Mani ai	laugh
mani ai	laughing
mani ai	laughter
galaw hpang ai	launch
rai hkrut ya ai shara	laundry
tara	law
tsing du pa	lawn
tara agyi	lawyer
galeng ai	lay
u di di ai	lay
htap	layer
tsang	layer
hkrang kasi	layout
kasi	layout
lagawn ai	lazy
numshawn	lead
woi awn ai	lead
hpa awn	leader
woi awn ai wa	leader
laika alam	leaf
namlap	leaf
kayun ai	leak
yun hkrat ai	leak
nyawt	lean
nhkrem	lean
gumlawt ai	leap
kagan mat wa ai	leap
hka ja ai	learn
hka ja taw ai	learning
sharin hkam la taw ai	learning
shaning galu hkoi shap ga sadi laika	lease
hkoi jaw ai lam	lease
yawm dik htum	least
shan hpyi	leather
ahkang	leave
Pru u	leave
Pru mat u	leave
ahkang	leaves
le mat ai	leaves
namlap	leaves
woi ningshawng ai	led
lam woi ai	led
machyu ai	led
pru mat wa sai	left
lapai maga de	left
ngam da ai	left
lagaw	leg
hkringhtawng	legacy
tara lam hte seng ai	legal
tara shang ai	legal
matsun maroi	legend
teng ai lam	legit
tara shang ai	legit
ban sa ai	leisure
hkoi shap ai	lend
shadawn shadang	length
shau ai	less
sharin hkam la hpa	lesson
ga	let
laika	letter
tsang	level
madang	level
lit nga ai	liability
jaw ra ai	liability
laika dum	library
mata sha ai	lick
shinglet hte kasut sha ai	lick
masu ai	lie
taw	lie
masu ai	lies
hka lem ai	lies
prat	life
ka aw	lift
jahpai	lift
aw	lift
nhtoi	light
tsang ai	light
myihprap	lightning
bung ai	like
zawn re	like
ra ai	like
byin na masa nga ai	likely
dai hte maren	likewise
maren	likewise
dai zawn	likewise
hkang	line
lam	line
Lingala	Lingala
matut ai	link
hkang hkyi	lion
jahku	liquid
ntsin	liquid
jahpan	list
jahpan galaw ai	list
madat u	listen
madat ai	listen
madat mara taw ai	listening
madat taw ai	listening
kaja nan	literally
laika	literature
maza jahkrat ai	litter
shanut shanawt	litter
loi mi	little
kaji ai	little
shanu(nga ai)	live
nga ai	live
sin	liver
shanu nga ai	lives
nga ai	lives
asak rawng ai	living
daw dap	living room
shingnyen	lizard
hka sin gu	lizard
magun lit	load
lit shagun ai	load
tawng	loaf
a ngaw hkawm ai	loaf
a jawt hkawm ai	loaf
hkoi shap ai	loan
buga ginra	local
buga ginra hte seng ai	local
nga shara	location
pad da ai	lock
sum saw	lock
hkum pat da ai lam	lockdown
tawng	log
mai lung	log
hpun tawng	log
garen ai	lonely
galu ai	long
N hkrum ai grai na sai	long time no see
nsam	look
yu ai	look
shanghkawng	loop
dawnggawng	loop
mat ai	loose
hkrat ai	loose
sum ai	loose
du	lord
madu	lord
hkrat sum ai	lose
shamat ai	lose
dinglut ai	lose
sum ai	loss
sum ai	lost
shamat ai	lost
dinglut ai	lost
yawng	lot
ngoi ai	loud
daw dap	lounge
Tsawra ai	love
Nang hpe tsawra ai	love you
tsawra dik ai	lovely
nyem ai	low
shagrit ai	lower
shanem ai	lower
shayu dat ai	lower
kang ka ai	loyal
sadi dung ai	loyal
sadi dung ai lam	loyalty
gam maka	luck
gam kaja ai	lucky
gam rawng ai	lucky
Luganda	Luganda
buhkawm yupra	luggage
buhkawm rai	luggage
tawng	lump
shani shat	lunch
sin wawp	lungs
pyaw hpa lam	luxury
zing hkam rai	luxury
u di di taw ai	lying
galeng taw ai	lying
jak	machine
ngawk ai	mad
pawt ai	mad
hpaw mi	madam
hkawp	madam
majan	madam
galaw ai	made
yam dek	magazine
laika buk	magazine
hkik hkam ai	magnificent
hpung shingkang rawng ai	magnificent
hkawn ram	maid
mahkawn	maid
madung	main
yu reng ai	maintain
yu reng ai	maintenance
Maithili	Maithili
madung	major
madung	majority
law malawng	majority
galaw ai	make
dawdan ai	make up
shakya rai	make up
La	male
gat dut shara	mall
La	man
hparen ai	manage
hparan ai	manage
hparan hpareng ai	management
ningbaw	manager
shadik shatup ra ai	mandatory
shadan shaleng tsun dan ai	manifest
lachyum pru ai	manifest
lata hte jum ai	manipulate
lata hte galaw ai	manipulate
lai nsam	manner
sat lawat	manner
lata hte seng ai	manual
lakchyoi	manual
law law	many
dawtsa	many
mana maka	many
Dai shani hta kabu kara ai lam law law lu la u ga	many many happy returns of the day
wut shata	march
rawt sa wa ai	march
nchyan	margin
matu	margin
gat	market
gat ginra	market
hkungran ai lam	marriage
hkungran da ai	married
dinghku hte re ai lam	married
myiman magap	mask
atawng apa rai	mass
missa hkungga	mass
tawng kaba ai	massive
htat ai	massive
grai kaba ai	massive
li ai	massive
sara	master
madu	master
htuk ai	match
manang	mate
madu jan	mate
madu wa	mate
arung arai	material
sawnhpan hpaji	math
lam	matter
myitsu ai lam	maturity
kunghpan lam	maturity
mai byin ai	may
rai na re	maybe
Ngai	me
Ngai mung	me too
Ngai ma	me too
shat lusha	meal
tsun mayu ai lam gaw	mean
lachyum pru ai	mean
lachyum	meaning
lachyum hpyen ai	means
lachyum	means
lachyum pru ai	means
lachyum pru ai	meant
laman	meanwhile
dai ten hta	meanwhile
shadawn ai	measure
sharam ai	measure
shadawn ai	measures
shan	meat
tsi hpaji hte seng ai	medical
tsi	medicine
tsi mawan	medicine
tara dung ai	meditation
ka'ang	medium
ram daw	medium
myi htoi	medium
hkrum ai	meet
zuphpawng	meeting
Meiteilon	Meiteilon
shabyawng ai	melt
matsing nyan	memories
sumhting nyan	memories
matsing nyan	memory
sumhting nyan	memory
myit hte seng ai	mental
madi madun ai	mention
htawng madun ai	mention
tsun dan ai	mentioned
tsun yan dan ai	mentioned
lam matsun madun ai wa	mentor
hpaga masha	merchant
hpaga la	merchant
n gaw n wai myit	mercy
matsan dum myit	mercy
majoi sha	merely
majoi mi	merely
Ngwi pyaw ai Hkritsmat	merry christmas
abut abye	mess
mazuk mazak	mess
matsun maroi laika	message
abut abye	messy
mazuk mazak	messy
nhprang	metal
mahkrun	method
yu ni	mice
ka-ang hkup	middle
yup tung	midnight
mai byin ai	might
sumnung ai	mild
madung lam	milestone
luk suk	military
hpyen	military
hpyen la hte seng ai	military
chyu	milk
chyu shup ai	milk
wan	million
masin salum	mind
myit	mind
myit jasat	mindset
ngai na	mine
gayau ai	mingle
hkawn bang ai	mingle
madung n re ai	minor
minit	minute
minit	minutes
lamik kum la	miracle
mau hpa lam	miracle
pat	mirror
n kaja ai gam maka byin wa ai	miscellaneous
n myit mada ai lam byin wa ai	miscellaneous
kajam kalam re ai	mischievous
myit n pyaw ai	miserable
jam jau ai	miserable
n ni n kri	misery
nchyi nmu lam	misery
dum ai	miss
ngam mat ai	miss
nang hpe dum ai	miss you
mat taw ai	missing
marit taw ai	missing
dumhprut taw ai	missing
dat kasa hpung, sasana hpung	mission
sai wan	mist
shut shai ai lam	mistake
Mizo	Mizo
htawt hkawm mai ai	mobile
jaw ai	mock
ajet n re ai	mock
ashu kau ai	mock
kamang	model
kasi	model
shadawn sharam ai	moderate
prat dep ai	modern
ya prat	modern
sari rawng ai	modest
gaya chye ai	modest
bam ai	moist
madi manyap nga ai	moist
bam masa	moisture
madi manyap masa	moisture
sharu	mole
prat	mole
anu	mom
chyahkring mi	moment
bat langai ya	monday
but sani	monday
gumhpraw	money
jawng ma ningbaw wa	monitor
reng hkang ai	monitor
up hkang ai	monitor
woi	monkey
shata	month
hkam sha lam	mood
myit sat lawat	moody
shata	moon
len	moral
hta n ga	more
hta sha n-ga	moreover
jahpawt manap	morning
rai shadun ai	mortgage
law malawng	most
madung hku nna	mostly
law malawng gaw	mostly
Anu	mother
shamu shamawt ai lam	motion
n-gun jaw ga	motivation
n-gun jaw ai lam	motivation
bum jinghkang	mountain
bum	mountain
yu	mouse
n-gup	mouth
sit u	move
htawt ai	move
shamu shamawt ai lam	movement
sumla hkrung	movie
jan	mrs
mana maka	much
hkum pa	mud
hkum pup	mud
kawk	mug
n-gun shan	muscle
madun gawk	museum
mati	mushroom
yu-ngwi	music
tup hkrak	must
ma a ai	mute
n chye shaga ai	mute
hti htang re ai	mutual
lahkawng maga	mutual
Ngai na	my
nye na	my
ngai na tsawra	My dear
ngai na nja	My dear
ngai na manang	my friend
Ngai na sabawng pyen li kaw gaw hkang shan tup hpring taw ai	My hovercraft is full of eels
Ngai na nja	my love
Ngai na tsawra	my love
ngai na mying gaw	my name is
ngai na tsawra myit re	my pleasure
madu hkum madu	myself
ngai nan	myself
lachyum sung ai	mysterious
chye na yak ai	mysterious
mauhpa lam	mystery
lachyum sung ai lam	mystery
mau mwi mau sa	myth
hpri woi na	nail
lamyin	nail
a ngawk ai	naive
mahkrum madup n nga ai	naive
mying	name
maumwi	narrative
n shu n shang	narrow
gyip ai	narrow
chyat ai	narrow
zai ai	nasty
nkaja ai	nasty
amyu sha hte seng ai	national
amyu sha amyu	nationality
dai daw ga	native
shingra tara	natural
shingra tara	nature
kraw galau ai	nausea
ka awn machyi ai	nausea
ani sha	near
ni ai	near
ni htep ai	near
ni ai	nearby
a ni sha kaw	nearby
hkawt	nearly
na daram	nearly
ganoi noi sha	nearly
yu htuk manu ai	neat
san seng ai	neat
ra ahkyak ai	necessary
ra ai	necessary
du	neck
ka chyi	necklace
du gali	necklace
ningra	need
ra ai	need
ninghkang ai	negative
nda de	negative
n gau shinggang di ai	neglect
myi man shinggang kau ai	neglect
hting rat ya ai	negotiate
hting rai ya ai	negotiate
hting bu	neighbor
htingbu	neighborhood
langai ma n re	neither
kahkri	nephew
kanam	nephew
myit kahpra ai	nervous
u tsip	nest
sumgawn	net
sut	net
mahkri	network
hkailau hte seng ai	neutral
tsep kawp	never
kalang pyi	never
galoi asum hkum jaw	never give up
myit galoi hkum daw	never give up
hpa n ra ai	never mind
myit kaw hkum bang da	never mind
hpa hkum sawn	nevermind
myit kaw hkum bang da	nevermind
raitim mung	nevertheless
nnan	new
ning nan	new
shiga	news
hpang langai	next
ya na	next
makau kaw	next to
Mai kaja dik sai	nice
hkrak sai	nice
Hkrum zup lu ai majaw grai kabu sai	nice to meet you
kanam	niece
shana	night
yup dip	nightmare
jahku	nine
shi jahku	nineteen
jahku shi	ninety
N re ai	No
manghkang n nga ai	no problem
byin na lam n nga ai	no way
n mai byin ai	no way
kadai ma n re	nobody
mahku	noise
arung	noisy
hpa n re ai	none
shani ka ang	noon
n re	nope
gara mung nre ai	nor
lahkawng yen n re ai	nor
hkrak sha re	normal
masa hte maren re	normal
dingdung de	north
ladi	nose
nta marit ana	nostalgic
n re	not
yawng n re	not at all
ram nga ai	not bad
hkrak nga ai	not bad
Ya n re	Not now
grai n re shi ai	not yet
matsing laika buk	note
matsing ai	note
mying kaba ai	noted
mying gumhkawng ai	noted
Kaman lila	nothing
Hpa n re	nothing
dum dat ai	notice
sadi jaw ai	noticed
myit maju jung ai lam	noticed
matsing da ai	noticed
mying ni	nouns
shingteng ni	nouns
sumroi laika	novel
maji ta	november
Ya	now
ndai prat hta gaw	nowadays
ya dai ni ten hta gaw	nowadays
myit n ji nmu byin hpa	nuisance
akyu n nga ai	null
kaman re ai	null
a ngawk ai	numb
nuk ai	numb
hti hkum	number
tsi sara num	nurse
kawp ja ai namsi	nut
kawp ja ai namsi	nutmeg
hkrum ra lu sha	nutrition
ga shaka	oath
dagam ga	oath
ahtun ai lam	obesity
grai hpum ai lam	obesity
hkan nang ai	obey
ninghkap ai	object
masa	objective
arai	objective
lit	obligation
magap tawn ai	obscure
n dan dawng ai	obscure
n dan leng ai	obscure
masat masa galaw lu ai lam	observation
maram masam yu ai lam	observation
yu ai	observe
mada ai	observe
mayawn ai	obsessed
masa mat ai	obsessed
myit chyung ai lam	obsession
myit hta rawng mat ai lam	obsession
prat madang ndep ai	obsolete
akyu nrawng ai	obsolete
numdaw numdan	obstacle
dingbai dinla	obstacle
hkap la lu ai	obtain
lu la ai	obtained
shakut lu la ai	obtained
dan leng ai	obvious
dan dawng ai	obvious
adan aleng	obviously
dan leng ai	obviously
masa hta hkan n na	occasionally
kan bau bungli	occupation
shang nga ai	occupied
shadu la ai	occupied
shara la kau ai	occupied
sawn la ai	occupied
byin pru wa ai	occur
byin pru wa ai	occurred
rawt byin wa ai	occurs
byin pru wa ai	occurs
nammukdara	ocean
hka dan	ocean
kala ta	october
lak lai ai	odd
tai	odd
tai sha	odds
atai re ai ni	odds
a	of
na	of
she rai	of course
jahkring ai	off
hkring ai	off
n ra ai	offensive
chye ai	offensive
hkungga jaw ai	offer
jaw ai	offer
rung	office
tara shang ai lam	official
tara shang ai rai	official
Jahkring hkring	often
kaja re i	oh really
sau	oil
namman	oil
Mai sa	ok
hkrak sai tsaw	ok dear
mai sa nja wa e	ok honey
maisa tsawra	ok my love
Mai kaja sai	okay
Mai sa nja	okay baby
kaja sai tsaw	okay dear
mai sa tsawra	okay honey
mai sa tsawra	okay my love
kaba ai	old
dingsa	old
Ntsa e	on
Ntsa hta	on
kalang ta	once
langai	one
Tsun shaga ai ga langai hte sha gaw galoi n law ai	one language is never enough
shakau hkyeng	onion
sha	only
hpaw ninghtan ai	open
hpaw da ai	open
kadoi ga ai lam	operation
hpyen gasat ai lam	operation
mu mada ai lam	opinion
ning mu	opinion
ahkaw ahkang ni	opportunities
ahkaw ahkang	opportunity
nhtan shai ai	opposite
kaja ai myit rawng ai	optimistic
kaja ai mu chye ai	optimistic
lata la na ahkang	option
mai lata la hpa	optional
shing nrai	or
lwi dwi si nsam	orange
lwi dwi si	orange
matsun	order
lawu tsang	ordinary
hpung kaba	organization
npawt gindai	origin
daipawt daihpang	origin
madung re ai	original
Oromo	Oromo
jahkrai nmai	orphan
jahkrai ma	orphan
shaje	other
kaga	other
laga	other
maga mi	otherwise
kaga lam	otherwise
ging ai	ought
anhte a	our
Anhte a lit: Shara shagu na masha shagu mungkan hpe chyena lu na hte ga amyu myu hku nna tinang hkum hpe tinang tsun dan lu na matu re ai	Our mission: to enable everyone, everywhere to understand the world and express themselves across languages.
Anhte a lit: Mungkan shiga ni hpe hkrang shapraw nna, yawng a matu akyu rawng ai hte lu mai hkra galaw na matu re ai	Our mission: to organize the world's information and make it universally accessible and useful.
shing gan de	out
pru	out
pru sa ai lam	outcome
pru wa ai akyu	outcome
mahtai	outcome
hking	outfit
pru mat wa ai	outgoing
pru lam	outlet
pru na shara	outlet
ga hkrang masa	outline
shinggan de	outside
ningtawn ai	outstanding
di jang	oven
ngut mat sai	over
lai mai sai	over
ntsa e	over
htawra kaw	over there
yawng	overall
tawt lai lu ai	overcome
myit shalai mat ai	overthinking
ladu lai myit ai	overthinking
kaput ai	overwhelmed
ka up kau ai	overwhelming
lim mat ai	overwhelming
lit nga ai	owe
hka kap ai	owe
u hku	owl
madu ai	own
madu	owner
u tang	ox
dumsu u tang	ox
hkam	pace
magun lit	pack
lit	pack
matep	package
makai	package
shabawn	package
shata shabai	paid
wa ai	paid
gumhpraw jaw ai	paid
machyi ai	pain
sumla soi tsi	paint
tsi chya ai	paint
sumla soi ai	painting
gup	pair
yan	pair
nsam kya ai	pale
kya ai	pale
lata lahpan	palm
namhtan hpun	palm
di jang	pan
di dam	pan
ana zinli	pandemic
kajawng kaja re ai	panic
tsang taw ai	panic
bu hkra	pants
mai sau	paper
sumsing mungdan	paradise
kapyawn ai	parallel
dinggreng di da ai	parallel
majaw	parcel
makai	parcel
mara raw ya ai	pardon
kanu kawa	parents
mawdaw jahkring da shara	park
nampan sun	park
hkai ke	parrot
hpak ki	parsley
daw chyen daw sang	part
daw shan	part
shang lawm ai	participate
ding hkrai	particular
lak lai ai	particularly
a lak mi re ai	particularly
ningrum ningtau	partner
hpung	party
hprang ai	pass
tawt lai ai	pass
hkrun lam	passage
lam	passage
dinghkren lai wa ai	passed
lai wa ai	passed
dinglai ai	passed
myit rawt ai	passion
myit shang sha lam	passion
grai myit lawm ai	passionate
grai myit rawt ai	passionate
a ngwi a ngawn ga	passive
kahtet kamawt nre ai	passive
ga makoi	password
moi moi	past
moi na	past
ga lawk kaji kapa ai	patch
hkang	patch
lam	path
matsan dum na zawn re ai	pathetic
yawn hkyen ai	pathetic
myit galu ai	patience
sharang ai	patience
Machyi masha	patient
Myit galu ai	patient
maka	pattern
chyahkring mi hkring sa ai lam	pause
jahkring da ai	pause
lung nyep	pavement
lung nyep lam	pavement
jaw ai	pay
shabrai jaw ai lam	payment
shabrai	payment
gumhpraw jaw ai lam	payment
simsa lam	peace
simsa ai	peace
ngwi pyaw simsa ai	peaceful
sumwum si	peach
bum pungding	peak
bumsen	peak
magaw si	pear
shapre ni	peas
lak lai ai	peculiar
alak mi re ai	peculiar
jit ji ai	pee
yen kau ai	peel
gaw kau ai	peel
sep kau ai	peel
du magam wa	peer
du magam wa	peers
mahkret shingna	pen
mahkret shingna	pencil
hke dan	pencil
mahkret chyang	pencil
jahkring da ai	pending
masha	people
majap lawm	pepper
hkaja hkrup ai	perceive
mu hkrup ai	perceive
mu mada ai lam	perception
ning mu	perception
hpring tsup ai	perfect
shachyen ai	perform
galaw ai	perform
hkrang shala ai	performance
galaw shachyen ai	performance
nhten	perhaps
mai byin ai	perhaps
aten ladaw	period
grin ai	permanent
ahkaw ahkang, ahkang aya	permission
ahkang jaw ai	permit
ahkang a ya	permit
shakut shaja ai lam	perseverance
marai dat ai lam	perseverance
shakut sharang ai	persistent
masha langai	person
marai hkum hte seng ai	personal
hkum mari	personality
lai nsam ningja	personality
mu mada ai lam	perspective
ningmu	perspective
gunglau ai	persuade
n hkru n kaja ai	pervert
lam yit ai	pervert
nta rem dusat	pet
galu kaba wa madang	phase
byin nga masa lam	phenomenon
myit mang hpaji	philosophy
dat sumla	photo
ga majaw	phrase
ga shingkyang	phrase
gawng shingyang	physical
dagawt ai	pick
lata ai	pick
wai	pick up
hta ai	pick up
manaw yu	pick up
sumla	picture
ahkyep alep	piece
hkyep ni	pieces
chyen ni	pieces
wa	pig
u ra	pigeon
sumpum	pile
tawn ai	pile
bunghkum	pillow
baw hkum	pillow
pyenli hkang ai wa	pilot
samyit	pin
jang wawm si	pineapple
sumwum pu nsam	pink
nsung hku	pit
nsen nyem tsaw	pitch
myit du ai	pity
matsan dum ai	pity
myit n pyaw hpa	pity
shara	place
shara	places
palik ana	plague
prang	plain
layang	plain
masing masa	plan
jak pyen li	plane
hkai ai	plant
ban ai	plant
hkai ai	plants
hpun kaji	plants
shat ban	plate
ban	plate
pinra	platform
dum	play
ginsup	play
shala chyai taw ai	playing
ginsup taw ai	playing
pyaw ai	pleasant
ngawn ai	pleasant
nga ai	pleasant
Chyeju hte	please
ra sharawng ai	pleased
kabu ya ai	pleased
pyaw hpa	pleasure
mau hke hka	pledge
ga sadi	pledge
sumpum mi	plenty
shara	plot
hting ra	plot
pa	plot
matsut	plug
matsut tawn ai	plug
mahkaw si	plum
hka ting rat matut ai wa	plumber
langai hta grai law ai	plural
law ai masa	plural
ga shagawp	poem
ningchying ga	poetry
ga shagawp	poetry
masen ai	point
htawng madun ai	point
ntuk	poison
gung	poison
pya da	police
ga shaka laika	policy
Sumnung ai	polite
awu asin re ai lam	pollution
nawng	pond
hka lawng	pool
hka la ing	pool
sanghpaw mai maga	poop
matsan ai	poor
kapaw pru nsen	pop
masha ra law ai mying kaba ai	pop
kapaw ai	pop
mying kaba ai	popular
mying gumhkawng ai	popular
masha jahpan	population
wa shan	pork
hpa	porridge
hka daru	port
sanghpaw daru	port
madang	position
kaja ai lai len	positive
lu madu ai	possess
nat kap ai	possess
lu la ai	possess
kyem ai	possession
maga ai	possession
lu la ai hpe madun ai ga	possessive
lu la tawn ai rai hte seng ai	possessive
mai byin ai	possible
shadaw	post
nhtoi htawt kau ai	postpone
jahkring tawn kau ai	postpone
yang yi	potato
byin mai ai lam	potential
adawt ai	pound
htu ai	pound
matsan ai	poverty
n-gun	power
hpung kaba ai	powerful
daru magam lu ai	powerful
ta tut re ai	practical
ta tut mai ai	practical
shaman shakyang ai	practice
shakawn ai	praise
shala ai	prank
tawng ban ai	pray
a kyu hpyi ai	pray
manu dan ai	precious
tuphkrak	precise
azin ayang re ai	precise
tuphkrak rai hkra	precisely
azin ayang rai hkra	precisely
hkaw ya ai	predict
myi htoi ga tsun ai	predict
mayu ai	prefer
ningshawng jaw ai lam	preference
hkumgawng li ai	pregnant
na um na sin re ai	pregnant
ma gun ai	pregnant
myiman lata ai lam	prejudice
nta wang	premises
pahkam gumhpraw	premium
hkyen lajang ai	preparation
hkyen lajang ai	prepare
shachyip da ai	prepared
hkyen lajang da ai	prepared
ga madun	preposition
shara shatsam da ai	presence
du dung lawm ai lam	presence
ya	present
kumhpa	present
htawng madun ai	present
madun da ai lam	presentation
tang madun ai lam	presentation
kyem mazing da ai	preserve
ningbaw	president
gumsan magam	president
dip gamyet ai	press
dip n-gun	pressure
sumhpai ai	pretend
grai nan	pretty
Tsawm htap ai	pretty
makawp maga ai	prevent
moi na	previous
kashun kashe sha ai	prey
manu jahpu	price
manu	price
arawng sadang	pride
hpung up sara	priest
madung	primary
hpa awn wa	prime
kaba htum ai wa	prime
ahkyak dik re ai	prime
hkawseng shayi	princess
hkawhkam nangshayi	princess
tara agyi	principal
shawng	prior
madung tawn ai	prior
re nrai shi yang	prior
madung tawn ai	priority
htawng	prison
garu kachyi n nga ai shara	privacy
dinghkrai	private
laksan ahkaw ahkang	privilege
shagrau kumhpa	prize
mai byin ai lam	probably
mayak	problem
manghkang	problem
htung lai sa	procedure
matut manoi	proceed
matut galaw ai	proceed
mabyin	process
masa	process
shapraw ai	produce
gunrai	product
gunrai shapraw ai lam	production
kan bau bungli	profession
kan bau bungli hte seng ai lam	professional
prat labau kadun n gyeng sumla	profile
amyat	profit
lachyum sung ai	profound
jat wa ai	progress
rawt jat wa ai	progress
sawn hpajang magam	project
danhkung	prominent
ga sadi jaw ai	promise
shatsaw ya ai	promote
aya sharawt ya ai lam	promotion
ya jang jang	prompt
kalang ta	prompt
shagum up re ai	prone
myinghkawt	pronouns
ga	pronouns
ga nsen	pronunciation
sakse	proof
htuk manu ai	proper
ai	proper
ai rai	properly
ai sha	properly
madu ai arai	properties
sut gan	properties
sut rai	properties
a rai	property
aja sut gan	property
tang madun ai lam	proposal
myit mada shara	prospect
dam lada ai myi n shat	prospect
wunli ring ai nga mu nga mai ai lam	prosperity
sut wunli chying wa ai	prosperous
sut ring ai	prosperous
sut su nga mai ai	prosperous
makawp maga ai	protect
arawng la ai	proud
chyam dinglik dan ai	prove
sakse madun dan ai	prove
ya ai	provide
karum jaw ai	provide
karum ya ai	provide
madi shadaw ya ai	provide
garum madi shadaw ai	provided
ginwang	province
jahkrat masat tawn ai lam	provision
lusha jarik	provision
hkawn ram prat	puberty
shawa mung hte seng ai	public
ninggawn shawa mung shawa singa	public
gang ai	pull
hkahkum si	pumpkin
aten hkrak hkrak re ai	punctual
jawng ma	pupil
sape	pupil
mari la ai	purchase
ajet re ai	pure
majing re ai	pure
san seng ai	pure
shaba pu nsam	purple
yaw shada ai lam	purpose
gumhpraw sumbu kasha	purse
hkan nang hkan sa	pursue
matut manoi galaw	pursue
hkan tam ai lam	pursuit
ganawng ai	push
htu ai	push
tawn ai	put
marai ningja	qualification
atsam ningja	quality
hti hkum	quantity
lak san garen da ai shara	quarantine
ga law hkat ai lam	quarrel
ga law ga la	quarrel
mare lawk	quarter
jik mi sumpum mali na langai	quarter
Quechua	Quechua
Hkawhkam jan	queen
Num hkawhkam	queen
lak lai ai	queer
alak mi re ai	queer
hkan sagawn ai lam	query
ga san kumla	query
san sawk ai lam	query
ga san	question
kara hkri ai	queue
tsap ding greng ai	queue
lawan ai	quick
zet let ai	quick
larau ladau	quick
lawan ladan	quickly
shim	quiet
katsi katsang	quiet
azim sha	quiet
pasi nba	quilt
si htun nba	quilt
pru ai	quit
tsawmra mi	quite
ga san shingjawng ai lam	quiz
la kap ai lam	quotation
la kap shaw la ai lam	quotation
la kap la ai	quote
la kap la ai	quotes
la kap shaw la ai	quotes
Prangtai	rabbit
shing jawng lamang	race
amyu bawsang	race
n yun	rage
pawt sin dawng ai	rage
marang	rain
shalat ai	raise
jun ai	raise
sharawt ai	raise
shalun ai	raised
sharawt ai	raised
ladawn ai	raised
ka gat ai	ran
hta hkrup	random
masat masa madang	range
chyang ai	rapid
lawan ladan re ai	rapid
a lawan sha	rapidly
lawan ladan	rapidly
taw ai	rare
taw dik ai	rarely
jan maru	rash
atin shapun re ai	rash
yu	rat
manu	rate
ram ram	rather
htam	ratio
myit sumru yu chye ai	rational
myit yu chye ai	rational
katsing	raw
du ai	reach
dep ai	reach
du ai	reached
dep ai	reached
hti htang galaw ai lam	reaction
hti ai	read
laika hti ai	reading
jin sai	ready
kaja sha	real
jet ai	real
kaja wa teng ai lam	reality
tatut re ai lam	reality
dumhprang ai	realize
myit hprang ai	realize
hkawn hkrang ai	realize
chye na myit hkawn wa ai	realized
kaja wa i	really
kaja sha	really
shing du de	rear
hpang de	rear
mabyin lam	reason
hkap la mai ai lam	reasonable
sawn dinglik mai ai lam	reasonable
bai shaga la ai	recall
bai myit dum hprang ai	recall
hkap la lu ai	receipt
ja	receive
hkap la ai	receive
hkap la lu ai	received
ya hte sha	recent
ndai laman hta sha	recent
ndai laman	recently
hkalum poi	reception
poi shingra	reception
matsun	recipe
tsi gayau matsun	recipe
kam mara re ai	reckless
n sadi ai	reckless
matsing masat da ai lam	recognition
matsing ai	recognize
yin la ai	recognize
hkap la ai	recognize
madi shadaw ai	recommend
madi shadaw ai	recommended
masat masa	record
bai hkam kaja wa ai	recover
bai lu la ai	recover
bai lu la ai lam	recovery
jut ding mali lawk zawn re	rectangle
hkyeng ai	red
hkrang shaw la ai	redeem
galai la ai	redeem
shaw la ai	redeem
galai la ai	redemption
shayawm ai	reduce
law htam ai	redundant
mahta ai	refer
lashum laika	reference
lakap laika	reference
pat shingna jung ai	reflect
myit aru yu ai	reflect
bai myit aru yu ai lam	reflection
pat shingna	reflection
koi gam ai	refrain
koi kau ai	refrain
hka shage sadek	refrigerator
katsi jak	refrigerator
gumhpraw bai n htang ai	refund
koi kau ai	refuse
ninghkap ai	refuse
ning dang kau ai	refused
ning hkap kau ai	refused
sawn la ai	regard
yu ai	regard
seng nna	regarding
ahkyak n tawn	regardless
myit dum let	regards
hkawng	region
ginra	region
jahpan bang ai	register
ka matsing jahpan laika	register
myit malai lu ai	regret
myit n pyaw ai	regret
shawoi	regular
aten hkrak hkrak	regularly
masa jaw ai	regularly
ningdang kau ya ai	reject
shabai kau ai	reject
hkai tsun dan ai	relate
matut mahkai ai	relate
amyu daw ai	relate
chyaw ai	related
daw ai	related
mahku mara ai lam	relationship
jinghku jingyu	relative
makyin jinghku	relatives
jinghku jingyu	relatives
ban	relax
shapru ai	release
dat ya ai	release
shapraw ya ai	released
raw dat ai	released
dat ya ai	released
htap htuk manu ai	relevant
mai kam hpa ai	reliable
kam mai ai	reliable
karum ningtum	relief
hkyam sa jaw ai	relieve
hkyem sa jaw ai	relieved
nawku htung hte seng ai	religion
makam masham	religion
makam masham grai shakut ai	religion
nawku htung hte seng ai	religious
makam masham hte seng ai	religious
kanung	reluctant
myit n hkrum ai	reluctant
kamhpa ai	rely
manem	rely
hti	remain
jan ai	remain
naw ngam ai	remain
ngam ai	remaining
matsing la mai ai	remarkable
matsing da mai ai lam	remarkable
tsi lajang ai masa	remedy
tsi lajang ai	remedy
dum ai	remember
myit dum ai	remember
dum shai ai	remember
shadum jahprang ai	remind
shadum jashai ai	remind
shadum jahprang ai lam	reminder
tsan gang	remote
la kau ai	remove
shaw kau ai	remove
mala kau ai	remove
ga gale ai	render
gam jaw ai	render
shap shabrai	rent
ga hkang	rent
byeng ai	repair
me ai	repair
kahtap di ai	repeat
kahtap tsun ai	repeat
malai bang ai	replace
nhtang ai	reply
htai ai	reply
shana ai	report
tang madun ai	report
malai tai ai	represent
gawng malai	represent
gumhkawng ai	reputation
arawng sadang	reputation
hpyi lajin ai	request
hpyi shawn ai	request
ra ai	require
ra ahkrak ai	require
ra rawng ai	required
ning ra ai	required
ra ai	required
hkye mawai la ai	rescue
mawai la ai	rescue
sai la ai	rescue
sawk sagawn ai	research
bung ai	resemble
masin pawt ai lam	resentment
ngam da ya ai lam	reservation
lak san tawn da ya ai shara	reservation
masat tawn da ai	reserve
ngam da ya ai	reserve
nga ai wa	resident
hkring mat ai	resign
pru mat ai	resign
hkam mana lu ai	resilience
hkin dit lamat chye ai	resilience
hkam jan lu ai	resilient
hkap shadaw ai	resist
hkap shadang ai	resist
hka shadaw ai lam	resistance
ninghkap gasat ai lam	resistance
ngang kang ai	resolution
dawdan lam	resolution
myit shatawng ai	resolve
myit jahkut ai	resolve
sa ra	resort
chyai ginra	resort
ban sa shara	resort
hpung tang sut sut rai	resources
myit gawat ai	resources
hkungga la ra ai	respect
htang shana ai	respond
gin htang ai	respond
bai htang ya ai	response
lit nga ai	responsibility
seng ang ai	responsibility
lit nga ai	responsible
sa la ai	rest
hkring la ai	rest
Ngwi pyaw ai hte ban sa nga u	rest in peace
lusha seng	restaurant
gram lajang ai	restore
tara hte tek jum tawn ai	restrict
mahtai	result
akyu ara	result
mahtai	results
akyu ara lu la ai	results
akyu ara	results
bai hpang ai	resume
hkyawt dut ai	retail
matut lu la ai	retain
mahkyu la lu ai	retain
tut kyem da lu ai atsam	retention
bungli hkring mat ai	retired
hkring sa ai	retired
n gun awai sharin hpawng	retreat
hting nut ai	retreat
zing la ai	retrieve
bai lu la ai	retrieve
bai wa ai	return
ginhtang ai	return
hpyan ai	reveal
shapyan	reveal
hpaw tsun dan da ai	revealed
hpaw shaleng dan da ai	revealed
hka htang ai	revenge
matai htang ai	revenge
hkang se	revenue
shang gumhpraw	revenue
ngam da ya ai	reverse
lak san tawn da ya ai	reverse
bai dinglik yu ai	review
bai gram lajang ai	revise
gin htang lajang ai	revise
bai yu ai lam	revision
nnan kaw n na bai ginhtang sharin ai lam	revision
rawt malan ai lam	revolution
gumlang ai lam	revolution
shagrau kumhpa jaw ai	reward
shagrau kumhpa	reward
yu kap nsen	rhythm
garep nra	rib
jawng lapa	rib
shat	rice
n-gu	rice
lauban ai	rich
lu su ai	rich
hprun kabai kau ai	rid
jawn ai	ride
hkang ai	ride
jau ai	ride
n mai byin ai lam	ridiculous
lachyum n rawng ai	ridiculous
lahkra maga de	right
teng ai	right
jaw ai	right
ya jang jang	right now
tara ja ai	rigid
tachyawp	ring
ngoi ai	ring
kashin agrak kau ai	rinse
arut kashin kau ai	rinse
kabrawng ai	riot
ruk rak ai	riot
gang jen kau ai	rip
aten du sai	ripe
myin ai	ripe
jat wa ai	rise
rawt ai	rise
tsang hpa	risk
shingjawng manang	rival
hka	river
lam kaba	road
ka i ai	roast
ka kang ai	roast
ju ai	roast
n-gun lagaw ja ai	robust
n-gun ja ai	robust
akam asham re ai	robust
lunghkrung	rock
shingna	rod
sumprang	rod
lit lamang	role
daw sang	role
taleng ai	roll
katsu ai	roll
nta n-gaw	roof
gawk	room
ru pawt	root
aru jung ai	root
ru ru ai	root
ningpawt	root
sumri	rope
yet mat ai	rotten
hpu ai	rotten
mazut ai	rough
yak hkak ai	rough
mazut ai	roughly
arut arat re ai	roughly
nru nra re ai	roughly
pawng pawng	round
gumdin	round
hkawm lam	route
lam	route
galaw laisa	routine
ding ren	row
arut ai	rub
ganun ai	rub
noi kret	rubber
shanut shanaw	rubbish
maza mala	rubbish
zai ai	rude
pa nep	rug
hten run mat ai	ruin
hten za mat ai	ruin
du wa	rule
mungdu	rule
uphkang ai wa	rule
pe dan	ruler
uphkang ai wa	ruler
mungdu	rules
uphkang ai wa	rules
ka gat ai	run
lagat ai	run
galaw taw ai	running
kagat taw ai	running
buga	rural
kyin ai	rush
tingsan	sack
n hpye kaba	sack
chyoi pra ai	sacred
ap nawng ai	sacrifice
shim ai	safe
shimlum ai	safe
shinglum ai pyen lam rai u ga	safe flight
shim lam	safety
alawng	sage
hpaji rawng ai wa	sage
tsun ai	said
jawn ai	sail
li yawng ai	sail
sumpan li	sail
li yawng hkawm ai	sailing
li jawn hkawm ai	sailing
gawp e	sake
marang e	sake
jaw e	sake
shabrai	salary
dut sha ai lam	sale
salmon nga	salmon
jum	salt
maren sha	same
bung ai	same
ndai kaw mung maren sha re	Same here
kasi rai	sample
kasi	sample
hkum tsai	sand
zai bru	sand
Sanskrit	Sanskrit
dung ai	sat
myit krem ai	satisfaction
myit dik ai	satisfaction
myit dik myit pyaw ai	satisfied
myit krem ai	satisfy
myit dik ai	satisfy
myit dik ai	satisfying
bat kru ya shani	Saturday
mashang shani	Saturday
wa pu shan jahkraw	sausage
zai ai	savage
zing da ai	save
sai la ga	save
mu ai	saw
tsun ai	say
nga ai	say
joi	scale
nma	scar
nma hkang	scar
taw ai	scarce
lu la yak ai	scarce
grai n law ai	scarce
hkrit ai	scared
shagri brep ai	scared
du gyit	scarf
hkrit tsang lam	scary
agat kau ai	scattered
jahtaw kau ai	scattered
shabra kau ai	scattered
shara	scene
myi hkru ginra	scenery
u hkru ginra	scenery
samu	scent
bat	scent
n ngawt	scent
aten mahkyen	schedule
jawng	school
hpung tang hpaji	science
hpungtang hpaji ninghkring	scientist
hpungtang hpaji ninghkring ni	scientists
zen dau	scissors
daru ai	scold
daru sharin ai	scold
myi gaiwang	scope
ginwang	scope
lu ai amat	score
kabai kau ai	scrap
adaw chyen	scrap
mahkyit ai	scratch
ahkrawt	scratch
ahkret	scratch
kyek ai	scream
jahtau marawn ai	scream
nba grang	screen
pan grang	screen
hpri nai	screw
lata laika	script
ka matsing	script
panglai	sea
dazik	seal
tam	search
ahkrawk	search
gasawk	search
duhkra ladaw	season
dung shara	seat
punghkum	seat
lahkum	seat
lahkawng	second
ning ip ga makoi magap tawn ai	secret
daw garan ai	section
daw	section
makawp maga ai	secure
shim ai	secure
ngang kang ai	secure
pahkam rai ga shaka laika	security
shim lam	security
mu ai	see
mu mada ai	see
bai hkrum ga	see you
hpang e bai hkrum ga	see you later
kade nna yang bai hkrum ga	see you soon
Hpawt de bai hkrum ga	see you tomorrow
tum	seed
nli tum	seed
nli	seed
sawk tam ai	seek
nawn ai	seem
htang ai	seem
zawn nawn ai	seem
zawn re	seems
mu kau da ai	seen
hkap rim la ai	seize
rim magra la ai	seize
rim la ai lam	seizure
kalang lang	seldom
lata san ai	select
lata la ai	select
madu hkum	self
hkum nan	self
madu hkum madu tsi la ai	self healing
madu hkum madu shamai la ai	self healing
machyu ai	selfish
tinggyeng myit	selfish
myit tawk ai	selfish
dut ai	sell
sa ai	send
shagun ai	send
Ngai hpe nang na sumla sa ya rit	send me your picture
arawng aya grau kaba ai wa	senior
lachyum	sense
maju	sense
myit sawn chye ai	sensible
myit sawn lu mai ai	sensible
machyi loi	sensitive
loi ai	sensitive
hkra loi	sensitive
shagun dat ai	sent
shabawn dat ai	sent
ga yan	sentence
ari jaw ai lam	sentence
ga yan	sentences
ari jaw ai lam	sentences
ginghka ai	separate
garan ai	separate
Sepedi	Sepedi
gumtung ta	september
hti hkum	series
laja lana re ai	serious
laja lana	seriously
asu a li	seriously
galaw jaw ai	serve
daw jaw ai	serve
daw jau	service
dakasu hpaji lamang	session
tara rung	session
zuphpawng	session
masat ai	set
gaw gap ai	set up
shakap ai	set up
chyarang sanglang ai	settle
sanit	seven
shi sanit	seventeen
sanit shi	seventy
law law	several
sawng ai	severe
chywi ai	sew
shingnip	shade
shingnang	shadow
ashun ashan di ai	shake
kanawn kawam ai	shake
ashun kau ai	shake
ging ai	shall
hka tang	shallow
kaya kahpa	shame
hkrang	shape
garan ya ai	share
gam jaw ai	share
gambum	share
dai ai	sharp
shi	she
shi kaw nga ai	she has
shi gaw	she is
dumsu lawng	shed
sagu	sheep
panyep	sheet
pa	sheet
di hpra	shelf
garap	shelf
hkoi kawp	shell
kawp	shell
shingbyi shara	shelter
nga shara	shelter
makawp maga ai	shield
ninggang	shield
htawt ai	shift
sit ai	shift
htoi kabrim ai	shine
sanghpaw li	ship
hka li	ship
sanghpaw hte kun rai htaw ai lam	shipping
lawnghkai	shirt
hkyep din	shoes
gap ai	shoot
sumla hkrung dem ai	shoot
rai mari ai	shop
gat seng	shop
gat mari hkawm ai	shopping
panglai hka kau	shore
kadun ai	short
dawk	short
nlaw nla re ai lam	shortage
dum hprut ai lam	shortage
sinat pala	shot
gap ai	shot
sinat goi nsen	shot
ging ai	should
lahpa	shoulder
kahpa	shoulder
jahtau ai	shout
marawn ai	shout
madun ai	show
Ngai hpe madun yu rit	show me
marang n zam	shower
marant mahpawng	shower
hkatsu	shrimp
htun mat ai	shrink
kyip mat ai	shrink
chyinghka la ai	shut
pat ai	shut
hking dit ai	shut
pat u	shut up
gaya ai	shy
kahpu kanau majing	sibling
kahpu kanau majing	siblings
machyi ai	sick
hkran	side
maga	side
gaham ai	sigh
nsa kaba shaw ai	sigh
mu lu ai lam	sight
gayin yu hkawm ai	sightseeing
ta masat	sign
ta maka	sign
sen	signature
lata masat	signature
lak lai ai	significant
dan dawng ai	significant
zim taw ai	silence
zim zam	silence
zim sha nga ai	silent
zim zam re ai	silent
lai	silk
lai ri	silk
sangawk	silly
mana ai	silly
gumhpraw	silver
raw	similar
bung pre ai	similar
a ngawk ai wa	simp
nyan tang ai	simple
myit marawng ai	simple
kaw nna	since
sumnung ai	sincere
myit su ai	sincere
myit malang ai	sincere
hkungga let	sincerely
hkawn ai	sing
mahkawn hkawn ai wa	singer
shingtai	single
lim ai	sink
Sara	Sir
kana	sister
kanau	sister
ning	sister in law
dung ai	sit
htinghput htingra	site
mabyin masa	situation
kru	six
shi kru	sixteen
kru shi	sixty
hkrang	size
masat masa	size
kung kyang lam	skill
kung kyang lam	skills
shan hpyi	skin
hpyi yen kau ai	skin
hpyi	skin
lasi ai	skinny
kri ai	skinny
shalai ai	skip
lamu	sky
mayam zawn galaw ai	slave
mayam	slave
yup ai	sleep
yup pyaw taw ai	sleeping
yup nga ai	sleepy
yup mayu ai	sleepy
palawng lawng ta	sleeve
galep ai	slice
kadoi ai	slice
mawt ai	slice
kashawt ai	slide
dumhpyut ai	slide
sumla chyasi	slide
kaji kachyaw	slightly
ahpa shala re ai	slim
lasi ai	slim
kaprau ai	slip
gashawt galau ai	slip
nyem rem	slope
lanyem ding ru	slope
hku kaji	slot
lanyan ai	slow
gau ngwi	slowly
a ngwi a bwi	slowly
kaji ai	small
grai byin ai	smart
sama	smell
sumsai	smile
mani ai	smile
wan hkut hku ai	smoke
wan hkut	smoke
hka yawm lu ai	smoke
mani ai	smooth
pri nyem ai	smooth
sha pri ai	smooth
muk	snack
hkoi	snail
lapawp	snail
lapu	snake
maja gawa makret ai	snap
grai lawan ai hku sumla dem ai	snap
hkyen	snow
Dai hku ngu yang	so
Shing rai yang	so
Rai yang	so
grai kaw lakai re ai	so cute
ya du hkra	so far
tsing tawn ai	soak
madit ai	soak
sabya	soap
bup tawng	soap
sadi sahka nga ai	sober
chyaru tsa nlu ai	sober
gawdin hpung	soccer
masha nga pra lam hte seng ai	social
uhpung uhpawng	society
maw za	socks
shakya	soft
sumnung ai	soft
akya	soft
kompyuta lamang ni	software
ga	soil
dut kau sai	sold
dut shama kau sai	sold out
dut kau sai	sold out
hpyen la	soldier
lagaw lahpan	sole
marai langai sha	sole
tinang chyu sha	sole
ngang kang ai	solid
langai sha re ai	solid
atawng apa	solid
mahtai	solution
jahpra ai	solve
hpran ai	solve
Nkau mi	some
langai ngai	somebody
gara hku raitim	somehow
gara hku rai rai	somehow
langai ngai	someone
lama mi	something
lama ma	something
kalang lang	sometimes
kalang marang	sometimes
ningchyin	song
yungwi	song
mahkawn ga	song
kade n na yang	soon
prat dep ai	sophisticated
mahkrum madup law ai	sophisticated
Sorani	Sorani
wunma	sore
hpye ai	sore
yu hkraw machyi ai	sore throat
yu hkraw hpye ai	sore throat
yawn hkyen lam	sorrow
Grai agam sai	Sorry
Tawngban ai	Sorry
myit n pyaw sai	Sorry
Hpyi nyem sai	Sorry
hpan	sort
amyu lata ai	sort
baw	sort
sawk kau da ai	sought
tam kau da ai	sought
wenyi	soul
prat manang	soulmate
nsen	sound
mahku ngoi ai	sound
si mai	soup
si mai ntsin	soup
hkri ai	sour
daju	source
marum	source
dingda	south
hpat wat	space
gum chyan	span
lahkam mi	span
hkyem sa jaw ai	spare
malai	spare
tsun ai	speak
shaga ai	speak
alak mi re ai	special
myu hpan	species
hkrak tup	specific
grai yu htuk na zawn re ai	spectacular
manaw	speech
matsun	speech
tsun na ga n nga mat ai	speechless
hpa nchye tsun mat ai	speechless
lawan shadang	speed
gasi hti ai	spell
jai lang ai	spend
aten jahtum kau ai	spent
jai lang kau ai	spent
jap ai	spicy
masen ai	spike
hpri masen	spike
ri kaboi ai	spin
salau lap	spinach
wenyi	spirit
mayen	spit
mahtaw kau ai	spit
prat kau ai	spit
hkik hkam ai	splendid
kaprang ai	split
ga ai	split
lagu la ai	spoil
kashun la ai	spoil
jahten kau ai	spoil
gashun la ai rai	spoiled
gashun la ai	spoiled
lagu	spoiled
jahten kau ai	spoiled
shi hte shi byin sa ai	spontaneous
matut manoi byin taw ai	spontaneous
lakung	spoon
chyaw	spoon
shara	spot
madu jan	spouse
madu la	spouse
ningrum ningtau jan	spouse
ningrum ningtau wa	spouse
bra ai	spread
hka bawng	spring
hka hpawk	spring
Lap run ginhtawng ta	spring
htam lahkawng sawn hku	square
man bung lawk	square
manat ai	squeeze
nyap la ai	squeeze
shup la ai	squeeze
kadu hka	squirrel
n hkyi hte galun ai	stab
ngang kang ai	stable
gumra lawng	stable
yihku bum sumpum	stack
bungli galaw masha	staff
nau ra	stage
pin ra	stage
tsi chya ai	stain
lakang ninggam ni	stairs
dumlawng ai	stake
dumlawng gumhpraw	stake
gam bum	stalk
seng gat sum	stall
laika dazik	stamp
hkin dit ai	stamp
dazik	stamp
tsap ai	stand
tsang	standard
madang	standard
shagan	star
hpang ai	start
hpang dat sai	started
hku	starving
shakyet ai	starving
lu sha shakyet ai	starving
mungdaw	state
ndau shabra laika	statement
wanleng daru	station
dabang	station
gawng ngu sumla	statue
hkrang sumla	statue
madang	status
nga ai	stay
shinglum hkra nga u	stay safe
ding ngam re ai	steady
dingyang re ai	steady
shan kangau ju	steak
lagu ai	steal
kabaw ai	steam
salu	steam
hpri gang	steel
tsing tawn ai	steep
kadawng ai	steep
n hkap ai	steep
hpun mat	stem
lakang n-gam	step
shing kawt ai	step
lagaw lahkam	step
shingna	stick
kap ai	stick
shakap ai	stick
ting ting hkang hkang re ai	stiff
yak ai	stiff
zim zam re ai	still
naw	still
zim ai	still
balen na ai	sting
ma ji ai	stingy
byet chyi ai	stingy
shalau ai	stir
shalut ai	stir
shalawn ai	stir
lusha kyem da ai lam	stock
arai	stock
lagu la da ai	stolen
shat kan	stomach
kan	stomach
nlung tawng	stone
tsap ai	stood
lahkum	stool
maza	stool
hkyi	stool
sa ai	stop
hkring ai	stop
gunrai tawn da shara	storage
zing da ai	store
kyem da ai	store
nbung laru	storm
maumwi	story
nta htap	story
nra wan dap	stove
ading sha	straight
dingyang	straight
dingding	straight
asan sha	straightforward
jen	strain
lak lai ai	strange
tsa sam	stranger
zai ladat	strategy
yi hku	straw
ka ka re ai	streak
hka shi	stream
hkrun	street
lam	street
atsam	strength
lapyin	strength
myit ba ai	stress
myit pu ai	stress
lata ladawn ai	stretch
laja lana	strict
yaw	strike
dup	strike
abrep	strike
sumri	string
tsam	string
hpyi gaw kau ai	strip
shakut shaja ai	strive
da ting shakut ai	strive
masawp ai	stroke
ngang ngang	strong
ngang kang	strong
n-gun ja ai	strong
akam asham	strong
kahpret kau da ai	struck
abyen kau da ai	struck
adit kau da ai	struck
hkrang	structure
shakut shaja ai	struggle
shakut shaja sha taw ai lam	struggling
baw ja ai	stubborn
masin ja ai	stubborn
chyat ai	stuck
adawng taw ai	stuck
jawng ma	student
hka ja ai	study
hka ja taw ai	studying
arung arai	stuff
htoi tu tsawm ai	stunning
angawk ai	stupid
anya ai	stupid
sateng	style
lai kasi	style
lai masa	style
ginhpan	subject
ginlam	subject
madat mara ai lam	submission
asum jaw ai	submit
tang madun ai	submit
mara ai	submit
ra hkyak dik ai daw	substance
atawng apa	substance
malai	substitute
malai bang ai rai	substitute
kya ai	subtle
nya ai	subtle
hkaw hkam aya hkap la ai	succeed
awng dang ai	succeed
hkring htawng daraw la ai	succeed
awngdang ai	success
awng dang ai	successful
ndai zawn re	such
zawn re	such as
chyup ai	suck
hkam la ai	suck
kalang ta	sudden
a kajawng sha	sudden
ma ja	sudden
kajawng kaja	suddenly
a kajawng sha	suddenly
hkam sha ai	suffer
hkam mana ai	suffer
hkrum sha nga ai	suffering
jamjau jamhkau chyum sha ai lam	suffering
wanwang	sufficient
grung ai	sufficient
jum dwi	sugar
hpaji jaw ai	suggest
hpaji jaw lam	suggestion
hpaji jaw ga	suggestion
hking	suit
htuk manu ai	suit
htap htuk ai	suit
htuk manu ai	suitable
htap htuk ai	suitable
bu hkawm rai sadek	suitcase
pawng ai	sum
yawng pawng	sum
ginchyum	summary
gadun dawk	summary
ginhtawng ta	summer
mahtaw n chyun	summit
bum pungding	summit
jan	sun
laban shani	sunday
majoi shani	sunday
jan ja ai	sunny
jan shang ten	sunset
jan shingkan	sunshine
grau htum ai	super
grau ai	super
grau ai masha ntsa na masha kaba	superior
grau ai	superior
reng hkang ai wa	supervisor
up hkang yu ang ai wa	supervisor
n yup shi yang sha ai shana shat	supper
karum jaw ai	supply
karum ningtum	supply
karum ning tum	support
karum ai	support
madi shadaw ai	support
myit nawn ai	suppose
myit nawn ai	supposed
zawn nawn ai	supposed
teng ai	sure
ndun	surface
taleng ai	surge
hka leng	surge
kadoi ga tsi hpaji	surgery
kadoi ga tsi mawan lam	surgery
htinggaw mying	surname
a kajawng sha byin ai	surprise
shamau kau ai	surprise
mau ai	surprise
a kajawng sha byin ai	surprised
shamau kau ai	surprised
mau shangun ai	surprised
laknak jahkrat ai	surrender
ninghtoi shang ai	surrender
asum hkam ai	surrender
gurp grup wang da ai	surrounding
makau grup yin	surrounding
u lam lam tawn ai lam	surveillance
tsan tsan kaw n na yu tawn ai lam	surveillance
sawk sagawn ai lam	survey
tawt lai lu ai	survive
n tsen ai	suspect
jahkring da ai	suspended
n tsen ai	suspicious
rai na shadu ai	suspicious
madi shadaw ya ai	sustain
bau tawn ai	sustain
hkrum sha ai	sustain
hkrung grin hkra galaw ai lam	sustainability
hkrung gin ai	sustainable
lagu la ai rai	swag
hka rai	swallow
gunrai shada galai ai	swap
dagam ga sadi la ai	swear
dagam ai	swear
dang ai	swear
salat pru ai	sweat
salat	sweat
salat hkam palawng	sweater
ding ye	sweep
ding ye ye ai	sweep
dwi ai	sweet
Yup mang tsawm mu u ga	sweet dreams
ga ngwi ga pyaw shaga chye ai	sweet tooth
sumtsaw	sweetheart
bum ai	swell
bum taw ai	swelling
ladau taw ai	swelling
hka hpung yawt ai	swim
hka hpung yawt taw ai	swimming
n goi	swing
goiwat	swing
kawat	swing
galai ai	switch
bum wa ai	swollen
ladau wa ai	swollen
lau nhtu	sword
masat dingsat	symbol
masat	symbol
kum la	symbol
matsan dum ai lam	sympathy
kumla	symptoms
htu jat	system
lai len	system
masa	system
sha ku	table
ahkrak la ai	tackle
lit la ai	tackle
masat	tag
mai	tail
n mai	tail
la ai	take
la sa mat ai	take away
la mat ai	take away
sadi u yaw	take care
pyen lung mat ai	take off
hprawng ai	take off
raw kau ai	take off
tsan kau ai	take off
shaw kau sai	taken
shaga mat ai	taken
la kau sai	taken
tsun shaga ai	talk
n gup nlem ai	talkative
grai jawp jin ai	talkative
galu ai	tall
kahtawk ai	tap
ahpa re ai sumri	tape
sumri chyahpa	tape
yaw shada ai	target
ban dung	target
lit	task
magam	task
chyim yu ai	taste
namchyim	taste
namta	taste
namchyim rawng ai	tasty
sharin ya ai	taught
matsun madun ai	taught
kang ai	taught
hpa lap	tea
sharin achyin ya ai	teach
Sara	teacher
Saranum	teacher
hpung kaji	team
hpung	team
je ai	tear
myi pri si	tear
shep	tear
myi pri si	tears
hkawt chyai ai	tease
shatsang chyai ai	tease
jak hpaji	technology
wa	teeth
tsun ai	tell
ngai hpe tsun dan rit	tell me
hpri shaja ai	temper
myit masin	temper
kahtet shadang	temperature
nawku jawng	temple
nawku nta	temple
jahkring jahkra	temporary
shi	ten
mun mi	ten thousand
shap galaw ai wa	tenant
shap nga ai wa	tenant
rem ai	tend
uphkang ai	tend
byin wa mai ai masa	tendency
kya ai	tender
wawp	tender
ding kren ai	tense
aten ladaw	tense
myit bu ba ai lam	tension
shingjawng ai lam	tension
nbung jawng ginsum	tent
janghpang	tent
chyam yu ai	tentative
chyam yu mai ai	tentative
aten ladaw	term
gasi ga ngau	term
ga masat	terms
ga hkin dat	terms
aten ladaw	terms
kahpra hpa	terrible
Hkrit kajawng hpa	terrible
hkrit tsang hpa	terrific
madu ai shara	territory
chyam ai	test
ga madung	text
ru di laika	text
lakap laika	text
hta grau	than
chyeju	thank
Chyeju kaba sai	thank you
Ya na zawn anhte jep joi(dinglik) taw ai ten hta myit galu galang hte la ya taw ai majaw chyeju dum sai.	Thank you for your patience while we investigate shipment
grai chyeju kaba sai yaw	thank you so much
grai chyeju kaba sai	thank you very much
Chyeju kaba sai	thanks
Anhte na app hpe lang ya ai majaw chyeju dum sai	Thanks for using our app
Dai	that
dai re	that is
dai she rai	that is
dai hkrak nga ai	that's good
hkrak ai	that's good
Dai	the
la gu la gut a mu	theft
shanhte na	their
shanhte	them
ga baw	theme
ga matsun	theme
shanhte hkum shanhte	themselves
dai hpang	then
dai ngut ai hpang	then
myit jasat	theory
myit masa	theory
dai kaw	there
dai shara e	there
dai kaw gaw	there are
dai kaw gaw	there is
dai majaw	therefore
ndai ni	these
Shanhte	they
Shanhte gaw	they are
htat ai	thick
lagut	thief
magyi	thigh
hpa ai	thin
a hpa	thin
lasi ai	thin
arai	thing
arai	things
sawn ai	think
myit ai	think
masum lang na	third
masum hta na langai	third
hpang gara ai	thirsty
shi masum	thirteen
sum shi	thirty
ndai	this
ndai gaw	this is
azing ayang	thorough
tsep kawp re ai	thorough
azin ayang	thoroughly
npawt ndung hkren	thoroughly
atsawm sha	thoroughly
dai ni	those
raitim mung	though
Myit ai lam	thought
Ning mu	thought
Mu mada lam	thought
atsawm myit yu n na galaw chye ai	thoughtful
myit mang ai lam	thoughts
myit jasat	thoughts
hking	thousand
ri	thread
hkrit shama ai	threat
shagyeng ai	threaten
sharim ai	threaten
jahkrit shama ai	threaten
masum	three
chyinghka hki bawng	threshold
chyinghka npawt nhpang	threshold
n shung si hpri	thrilled
ma ja grai kabu ai lam	thrilled
amyu hpan	thrive
yuhkraw	throat
lai ai	through
lam dingtung	throughout
kabai ai	throw
kabai bun ai	throw
lata yung nu	thumb
mu	thunder
mu ngoi ai	thunder
mu ngoi nsen	thunder
Bat mali ya	Thursday
dai majaw	thus
magra	tick
atek ngoi nsen	tick
wa hkali	tick
hka kanawng	tide
hka hpung rawt	tide
san seng ai	tidy
hkang	tie
gyit ai	tie
dun ai	tie
sharaw	tiger
hkak ai	tight
Tigrinya	Tigrinya
aten	time
n wam ai	timid
a gam ai	timid
hkrit kaya ai	timid
kaji dik ai	tiny
ningdung	tip
ga nchyan tsun dan ai	tips
ga nchyan	tips
ba ai	tire
pu mat ai	tire
ba ai	tired
pu ba ai	tired
mawm	tissue
gabaw	title
dai de	to
de	to
byin na matu	to be
na matu	to be
tsa lu saw ai	toast
ka kang ai	toast
daini	today
ma zawn agang hkawm ai	toddler
lagaw latsawng	toes
rau	together
jawm	together
namdum	toilet
tsun dan kau da ai	told
hkam sharing ai lam	tolerance
hkam sharang ai	tolerate
ba hkri si	tomato
hpawt de	tomorrow
shinglet	tongue
daina	tonight
mung	too
la ai	took
lakung lakap	tool
lakung lakap ni	tools
wa	tooth
ntsa	top
ndung	top
ga baw	topic
je kau ai	torn
shep kau ai	torn
adip arip di ai	torture
zing ri ai	torture
yawng ma hkra	total
gumhpawn	total
yawng hpawn	total
adawk	touch
kahtawk	touch
greng ai	tough
yak hkak ai	tough
bu hkawm ai	tour
mung jawt hkawm ai	tour
shawng de	toward
de	toward
shawng de	towards
hka shin hpajet	towel
mare	town
ntuk	toxic
gung	toxic
tam sagawn yu ai	trace
hkan sagawn yu ai	trace
lam matsun	track
galai ai	trade
hpaga ga ai	trade
ji woi masa	tradition
htung lai masa	tradition
htunghking	traditional
mawdaw lam	traffic
hkan nang ai	trail
garawt dun mat wa ai	trail
wan leng	train
jahpat ai	train
shakung ai	train
wunkat	training
lai	trait
lak lai ai sat lawat	trait
lai	traits
lak lai ai sat lawat	traits
shara htawt ai	transfer
galai kau ai	transfer
galai la ai lam	transition
galai mat ai lam	transition
laika gale ai	translate
ga gale ai	translate
asan sha mu lu ai	transparent
htaw wa htaw sa ai	transport
htaw hting let ai	transport
htaw wa htaw sa lam	transportation
chyinghtep mahkam	trap
shanut shanawng	trash
maza	trash
ningma	trauma
ningma hkang	trauma
hkawm ai	travel
ka htang	tray
sut gan	treasure
lanu lahku ai	treat
daw jaw ai	treat
tsi lajang ai	treat
htawk la ai	treatment
tsi tsi hkam la ai	treatment
hpun	tree
manu mana kaba ai	tremendous
grai hkrit tsang hpa re ai	tremendous
masa lam	trend
lam	trend
tara jeyang ai lam	trial
hpaji daw ai lam	trick
hkalem sha ai	trick
ba ai	tried
pu ai	tried
mawng ai	trigger
hkrawt kau ai	trim
mawn shatsawm ai	trim
hkrun lam kadun	trip
mayak	trouble
manghkang	trouble
labu galu	trousers
bu hkra	trousers
mawdaw kaba	truck
gunrai htaw mawdaw	truck
gun rai shada galai ai lam	truck
teng ai	true
jaw ai	true
hpun nu	trunk
kam hpa ai	trust
kam ai	trust
teng man lam	truth
shakut ai	try
Tsonga	Tsonga
byawng	tube
ting rat	tube
bat lahkawng ya	Tuesday
hpaji sharin ya ai lam	tuition
u magwi	turkey
namchying	turmeric
kayin ai	turn
gale ai	turn
taubren	turtle
hpaji kasi madun sara	tutor
shi lahkawng	twelve
hkun	twenty
hkun langai	twenty-one
Twi	Twi
htam lahkawng	twice
sumri manai makai di ai	twist
manai ai	twist
lahkawng	two
hpan	type
kaja	typical
zawn re	typical
ahtat awat	ugly
n tsawm ai	ugly
hpang jahtum na	ultimate
jahtum na daw dan ga	ultimate
jawng	umbrella
n dang di lu ai	unable
n byin lu ai	unable
Wa di	uncle
Wa ba	uncle
tsa ba	uncle
n dum hprang ai myit malap ai	unconscious
n dum myit	unconscious
npu e	under
kata	under
npu kaw	underneath
lawu kaw	underneath
manu shading mala la nlaw ai	underrated
chye na ai	understand
hkawn hkrang ai	understand
chye na lu sai	understood
n myit mada ai sha	unfortunately
bu hpun hking	uniform
maren re ai	uniform
laksan hking	uniform
lak lai	unique
shing tai yu nit	unit
langai	unit
kasi	unit
dakasu jawng	university
nchye la lu ai	unknown
nchye ai	unknown
nrai yang	unless
n re shi yang	until
shawoi hte n bung ai	unusual
ntsa	up
lahta	up
Nang na myit sha re	up to you
madang dep	update
madang shatsaw ya ai	upgrade
ntsa kaw	upon
lahta de	upon
myit n pyaw ai	upset
myit yawn ai	upset
mare kaba	urban
shadut	urge
larau ladau	urgent
hkyak hkyak	urgent
anhte	us
lang ai	use
jai lang ai	use
akyu jashawn ai	used
jai lang ai	used
asung jashawn ai	used
akyu rawng ai	useful
akyu n rawng ai	useless
lachyum n pru ai	useless
tut galaw nga ai	usual
shawoi na zawn sha	usually
akyu jashawn ai lam	utility
n-gun awai ai	vacation
makawp tsi htu ai lam	vaccination
tsi mawan	vaccine
kaman hpat wat	vacuum
npra ai	vague
ndan leng ai	vague
tara shang	valid
hka raw	valley
kadit laying	valley
manu dan ai	valuable
manu rawng ai	valuable
manu tawn ai	value
manu dan ai	value
hpan	variety
hkum sumhpa	various
sumhpa	various
shai ai	vary
n bung ai	vary
nampan kawk	vase
shara dam ai	vast
dam lada ai	vast
law htam ai	vast
nam law nam lap ni	vegetable
namlaw namlap hte seng ai	vegetables
jak rai	vehicle
sut ai wa	vendor
tuk	venom
ntuk	venom
asak dan nna galaw ai	venture
sakdan galaw ai lam	venture
nhkrit ntsang galaw ai bungli	venture
hkrum zup shara	venue
ginsup shingjawng shara	venue
teng ai lam hpe chye na matu jep ai	verify
NAlam amyu myu	versatile
ga gale tawn ai lam	version
ga gale tawn ai laika	version
grai	very
grai hkrak sai	very good
hka li	vessel
li	vessel
lai kau nna	via
lai nna	via
makau grup yin	vibe
makau grup yin	vibes
grai matse ai	vicious
grai n hkru ai	vicious
hka mara da chye ai	vicious
tsin yam hkrum masha	victim
sumla hkrung	video
ningmu	view
mu mada ai	view
buga	village
grai n hkru nshawp ai wa	villain
ntsin hkri	vinegar
tsabi si di ai ten	vintage
kashun kashe re ai lam	violence
laja lana re ai	violent
kashun kashe re ai	violent
ana kanu	viral
ajet re ai	virgin
hkawn sek	virgin
na daram	virtual
sari sadang	virtue
nden	virtue
shaman chyeju lu ai lam	virtue
shingran mu ai	vision
shingran	vision
sa du yu ai	visit
sa hkawm ai	visit
mu lu ai lam	visual
mu mada ai hte seng ai	visual
reng	vital
manu dan ai	vital
lachyum dan leng ai	vivid
dan leng ai	vivid
ga nsen	voice
mahku	voice
hpa mung n nga ai	void
kaman re ai	void
laika bap	volume
hkrang masat	volume
san san karum ai wa	volunteer
madawn ai	vomit
hkra machyi loi ai	vulnerable
byin loi ai	vulnerable
hkam sha loi ai	vulnerable
shabrai	wage
shabrai	wages
shata shabrai	wages
ginshang	waist
nshang	waist
mashi	waist
Naw lat u	wait
Jahkring mi	wait
hpajau wa	waiter
la taw ai	waiting
a la dingda nga ai	waiting
jasu ai	wake
rawt ai	wake
yup hprang ai	wake
rawt ai	wake up
lam hkawm ai	walk
lam hkawm taw ai	walking
shakum	wall
tingsan	wallet
htung pa	wallet
wam hkawm ai	wander
jawt hkawm ai	wander
mayu ai	wanna
ra marin ai	want
ra ai	want
ra sharawng ai	wanted
gasat gala majan	war
majan	war
bu hpun palawng sumpu	wardrobe
rai mahkawng da ai shara	warehouse
rai htun da ai shara	warehouse
lum ai	warm
sadi jaw ai	warn
sadi jaw ai lam	warning
hpyen la	warrior
gasat gala hpyen la	warrior
hkrut ai	wash
kashin ai	wash
ayai	waste
shama ai	waste
maza	waste
la yu taw ai	watch
sin	watch
hka	water
gin hkyau si	watermelon
lata dingsi ai	wave
hka leng	wave
lata wak ai	wave
mahkrun	way
lam	way
Anhte	we
Anhte gaw	we are
Anhte dang di lu ai	we can
n-gun yawm ai	weak
gawng kya ai	weak
gawng kya ai lam	weakness
nga mu nga mai ai lam	wealth
lu su	wealth
sut ring chying ai	wealthy
sut su ai	wealthy
hpun ai	wear
dagraw ai	wear
bu hpun sumraw da ai	wearing
gali da ai	wearing
du hkra ladaw	weather
hkungran poi	wedding
bat masum ya	Wednesday
tsing	weed
bat	week
laban bat kru ya hte sanit ya nhtoi	weekend
shen yu ai	weight
namnak ai	weight
dingdaw yu ai	weight
alak mi re ai	weird
Hkap tau la ga ai	welcome
ngwi pyaw hkam kaja ai lam	welfare
nga mu nga mai lam	welfare
Kaja sai	Well
hkrak sai	Well
grai hkrak sai	well done
sa ai	went
rai ma ai	were
sinna	west
madi ai	wet
nga magwi	whale
Hpa rai	what
nang gaw gara hku rai	what about you
Nang hpa galaw taw ai rai	what are you doing
Nang ya hpa galaw taw ai rai	what are you doing now
Nang ya hpa baw glaw taw ai rai?	what are you doing right now
nang hpa galaw ai	what do you do
Nang hpa baw kan bau bungli galaw ai rai	what do you do for a living
Nang hpa tsun mayu ai rai	what do you mean
Hpa lachyum rai	what do you mean
Nang hpa ra ai rai?	what do you want
hpa byin mat ai rai	what happened
hpa baw rai	what is
ndai hpa baw rai?	what is this
Nang na bungli gaw hpa rai?	what is your job
Nang na mying hpa rai	what is your name
hpa baw?	what's up
Nang na mying gara hku nga ai rai?	what's your name
Nang na mying hpa rai?	what's your name
hpa mi rai rai	whatever
hkaulan	wheat
gayin shakyi ai	wheel
leng	wheel
Galoi rai	when
Gara ten rai	when
hpa mi rai rai	whenever
Gara kaw rai	where
kanang na rai	where
Nang gara kaw rai?	where are you
Nang gara kaw na rai	where are you from
nang ya gara kaw rai	where are you now
Nang gara kaw nga ai rai	where do you live
gara kaw?	where is
majaw	whereas
rai yang	whereas
rai. nrai	whether
rai yang	whether
gara rai	which
Dai ten laman	while
Aten hta	while
Aten e	while
kahte tsun ai	whisper
kadum ai	whisper
lahpyaw hpyaw ai	whistle
a hpraw	white
Kadai rai	who
Kadai ta	who
nang kadai rai	who are you
kadai rai?	who is
Ndai wa kadai rai?	who is this
yawng	whole
tup	whole
kadai hpe	whom
kade na	whose
Hpa majaw rai	why
hpa na n re na	why not
n shawp ai	wicked
n hkru ai	wicked
dam ai	wide
dam lada ai	wide
gaida	widow
gaida jan	widow
nda	width
madu jan	wife
ningrum ningtau jan	wife
shazai	wild
namshan	wild
matse	wild
matsun maroi	will
sana	will
galaw mayu ai	willing
byin mayu ai	willing
mayu ai	willing
dang ai	win
nbung	wind
nbung bung ai	wind
hku wawt	window
hku wawt chyinghka	window
nbung laja ai	windy
tsabyi jahku	wine
tsabyi ntsin	wine
kashung ta	winter
arut kau ai	wipe
katsut kau ai	wipe
hpri sumri	wire
sin yu sumri	wire
zai	wisdom
hpaji hparat	wisdom
nyan marai	wisdom
htauli htaula rawng ai	wise
kyu hpyi ai	wish
kam ai	wish
Nang na shawnglam a matu a kyu hpyi ya ai	wish you all the best
nat kanu	witch
hpyi	witch
rau	with
dai hte	with
dawm la ai	withdraw
gun la ai	withdraw
shaw la ai	withdraw
shabai la kau ai	withdrawal
shaw la ai	withdrawal
lapran	within
n lawm ai sha	without
sakse	witness
sha a chyoi hpa chye ai	witty
chyahkyawn	wolf
nu num	woman
kanu num ni	women
dang ai	won
na n re	won't
mau ai	wonder
mau hpa	wonderful
nam	wood
hpun	wood
sagu mun	wool
ga	word
ga si ni	words
galaw ai	work
bungli	work
galaw ai	work out
di taw ai	working
galaw taw ai	working
mungkan ga	world
shingtai	worm
latung	worm
bu hpun sumraw ai	worn
myit tsang ai	worried
makran	worried
myit tsang ai	worry
myit ru ai	worry
n kaja ai	worse
hpyang ai	worse
nawku daw jau ai lam	worship
n kaja dik htum	worst
hpyang dik htum	worst
gingdan ai	worth
ging ai	worth
dan ai	worth
ging dan ai	worth it
dan ai	worth it
gingdan ai	worthy
manu dan ai	worthy
na re	would
na ra ai	would
hpye ai lam	wound
ning ma	wound
shinggrum ai	wrap
jahpun ai	wrap
gayawp tawn ai	wrap
n yun	wrath
sinpawt la htet ai	wrath
lata lahkre	wrist
ka ai	write
Ndai kaw ka jahkrat rit	Write here
ka tawn ai laika	writing
laika ka masa	writing
laika ka da ai	written
ka da ai	written
shut ai	wrong
laika ka kau da ai	wrote
ka kau da ai	wrote
dawng lahkawng shading	yard
sun wang	yard
kaham ai	yawn
Rai sa	Yeah
Re ai	Yeah
shaning	year
shaning ni	years
matsi	yeast
jahtau ai	yell
jahtau marawn ai	yell
ahtoi nsam	yellow
ahtoi nsam awng ai	yellow
Mai sa	Yes
re ai tsawra	yes baby
re ai n ja e	yes dear
re tsaw	yes honey
re tsawra	yes my love
re teng ai	yes of course
she rai	yes of course
mani	yesterday
ya	yet
ya du hkra	yet
sun	yield
Nang	you
nang gaw	you are
Nang grai tsawm ai	you are beautiful
Nang grai tsawm htap ai yaw	you are so beautiful
nang dang di ai	you can
Nang chye ai i?	You know
nang mung maren yaw	you too
nun ai	young
hkalung ai	young
asak kaji ai	young
Nang na	your
na hkum nang	yourself
Ramma	youth
mu dik ai	yummy
kaman	zero
