jun	a
jutz'it	a little
k'i	a lot
k'i	a lot of
uya'ik kanoq	abandon
ya'om kanoq	abandoned
uch'ijik	abide
kowinem	ability
kkowin chech ub'anik	able
chi rij ri	about
pa uwi' ri	above
pa jun chi tinamit	abroad
man k'olem taj	absence
man k'o taj	absent
jewi	absolutely
utz'ub'ub'exik	absorb
man ka'ilitaj taj	abstract
man jeta kub'ano	absurd
uk'iyal	abundance
uk'iyal	abundant
ub'anik k'ax	abuse
ukojik itzel jastaq	abuse
k'osnem	accent
uk'amik	accept
okik	access
okem	access
okib'al	access
uya'ik b'e	access
k'ax riqitajinaq	accident
k'olib'al	accommodation
uriqik	accomplish
tz'aqatisam	accomplished
k'amuq'ab'	according
kemb'i'aj	account
suk'il	accuracy
suk'	accurate
kojom tzijtal chi rij	accused
q'oxom	ache
q'oxom anima	ache
q'oxowik	ache
uch'akik	achieve
ch'akoj	achievement
uya'ik ub'ixik	acknowledge
eta'matalik	acquaintance
uriqik	acquire
ktajin kinriqo	acquired
uriqik	acquisition
ktajin kq'axik	across
b'anoj	act
b'anoj	action
k'olik	active
taq kemb'anowem	activities
b'anoj	activity
ajalib'al	actor
qas tzij	actual
ri qas ub'e'el	actually
nitz'	acute
uya'ik	adapt
uya'ik	add
k'amanaq che	addicted
mulinem	addition
uwi'	additional
b'enik	address
achochib'al	address
b'e	address
k'olib'al	address
suk' ub'e	address
qas utz	adequate
kuriq rib'	adjacent
q'alb'i'aj	adjective
usuk'maxik	adjust
lab'ajinik	admire
uya'ik b'e	admit
uk'amik	adopt
adorable	adorable
nab'ejinaq	advance
b'anom chik	advance
uwa'lijisaxik uwach	advance
uwa'lijisaxik	advance
nab'ejik	advance
paqalik	advanced
rutzil	advantage
ub'anik uk'amb'ejaxik	adventure
achb'anoj	adverb
ub'ixik	advertisement
ub'ixikil	advertising
uya'ik na'oj	advice
na'oj	advise
tob'anik	advocate
ajch'o'j	advocate
tob'anem	advocate
ch'a'ojinik	advocate
ch'umil	aesthetic
ucholajil	affair
kajawaxik	affect
loq'ob'al	affection
k'olem chi unaqaj	afford
rajilal	affordable
kuxe'j rib'	afraid
chi rij	after
b'enaq q'ij	afternoon
k'ate ri'	afterwards
jumul chik	again
chi uwach	against
junab'il	age
wokaj	agency
k'exob'al	agent
ka'n	aggressive
sib'alaj aninaq	agile
chi rij	ago
uk'amik uq'ab'	agree
k'amuq'ab'	agreement
tiko'nijik	agriculture
chi uwach	ahead
tob'anem	aid
retwechixik	aim
kaqiq'	air
kiq'ajb'al xik'ich'ich'	airport
ok'owib'al	aisle
wane'jb'al	alarm
tzam	alcohol
uya'ik ub'ixik	alert
k'aslem	alive
konojel	all
utz la' ne'	all right
ronojel ri utz	all the best
uya'ik b'e	allow
ya'om b'e chech	allowed
wene	almost
xewi	alone
pa uq'ijol rech	along
utz chik	already
Uk'amik uq'ab'	Alright
xuquje'	also
jun chik	alternative
pine'	although
amaq'el	always
in	am
sib'alaj je'lik	amazing
kch'ob'otaj taj	ambiguous
rayib'exik	ambition
kraj nik'aj chik	ambitious
usuk'maxik	amend
chi uxo'l	amid
chi uxo'l	among
chi qaxo'l	among us
uk'iyal	amount
sib'alaj utz	amusing
jun	an
unik'oxik	analysis
e qati't qamam	ancestors
uya'ik	anchor
ojer	ancient
xuquje'	and
chi'l at	and you
ajchikajil winaq	angel
oyowal	anger
tz'uk	angle
oyowal	angry
awaj	animal
uqul aqanaj	ankle
na'tajisaxik	anniversary
ub'ixikil	announcement
ub'anik k'ax	annoy
k'ax una'om	annoyed
k'ax una'om	annoying
chi junab'	annual
owatalik	anonymous
jun chik	another
utojb'alil	answer
uk'ulaxik uwach	answer
utzalijisaxik uwach	answer
tojik	answer
usolik uwach	answer
uya'ik ub'ixik apanoq	anticipate
mayowem	anxiety
karaj ub'anik	anxious
apachike	any
man kb'an ta chik	anymore
apachike	anyone
maj	anything
apachike ub'antajik	anyway
rech ronojel taq ub'antajik	anyways
jun chi peraj	apart
ja k'olib'al	apartment
uta'ik ukuyik makaj	apologize
ujulaxik	apparent
wene'	apparently
uya'ik uch'a'ik	appeal
k'utunsanem	appear
petib'al	appearance
xinq'alajinik	appeared
rayinem	appetite
mansa'n	apple
tz'onoj	application
ukojik	apply
sik'inem	appointment
uloq'oxik	appreciate
uya'ik q'ij	appreciation
qatem	approach
rilik	approach
q'atenik	approach
oqanik	approach
opanem	approach
qas utz che	appropriate
uya'ik b'e	approval
uk'amb'ejaxik	approve
ya'om b'e chech	approved
petinaq aq'anoq	approximately
ukaj ik'	april
man jetaj	arbitrary
k'uttz'aqonel	architect
k'uttz'aqonem	architecture
uk'olik	archive
are'	are
at k'o at	are you
man jamal ta awach	are you busy
at k'ulan chik	are you married
at k'ulanik on man at k'ulan taj	are you married or single
¿La at k'o na chla'?	Are you still there?
at k'o chla'	are you there
uqajb'al	area
tzijonem	argue
kolomal	argument
kamajix aq'anoq	arise
ch'u'k	arm
chajinel	army
chi rij ri	around
ub'anik rutzil	arrange
b'anom ub'anik	arrangement
opanem	arrival
opanem	arrive
xinulik	arrived
nimal	arrogant
ch'ab'	arrow
uje'lal chak	art
jastaq	article
man tzij taj	artificial
ajb'ix	artist
pacha'	as
are taq	as long as
xuquje'	as well
sib'alaj utz pacha'	as well as
chaj	ash
kak'ixik	ashamed
uta'ik	ask
xinto	asked
warnaq	asleep
upetib'al	aspect
Assamese	Assamese
ch'ayanem	assault
uwokik	assembly
qas utz	assertive
uk'amb'ejaxik	assess
upajik rij	assessment
k'olem	asset
e k'olik	assets
uya'ik	assign
chak	assignment
rilik	assist
tob'anel	assistant
uya'ik	associate
ya'om	associated
uya'ik	association
uk'amik	assume
kb'an che	assumption
pa	at
ruk' we	at least
xintij nuwa	ate
ajtikolanim	athlete
uya'ik	attach
k'o ruk'	attached
ya'om ruk'	attachment
tzurunem	attack
ub'anik chi jumul	attempt
ub'anik	attempt
ukojik chi chuq'ab'	attempt
kojik chuq'ab'	attempt
k'olem	attend
k'olem	attendance
utatab'exik	attention
ub'antajik	attitude
k'amik loq	attract
ilonem	attraction
sib'alaj je'l	attractive
ub'anik	attribute
tzijonem	audience
uwajxaq ik'	august
ch'utinan	aunt
ch'utinan	aunty
qas are'	authentic
ajno'j	author
taqanel	authority
saq'ij	autumn
jamal uwach	available
uk'u'x ajilab'al	average
uq'atik	avoid
k'ask'atem	awake
ch'akoj	award
kuchomaj rij	aware
k'oxomab'al	awareness
naj	away
maj jewi	awesome
sib'alaj k'ax	awful
man utz ta k'o wi	awkward
Aymara	Aymara
ne'	baby
man k'ulan taj	bachelor
chi rij	back
b'anom kanoq	background
itzel	bad
k'olib'al jastaq	bag
chab'al re	bait
umeqsaxik	bake
b'anb'al kaxlan wa	bakery
b'ikarb'onat	baking soda
uya'ik utojb'al	balance
ch'akik	balance
ch'akoj	balance
sowr	balance
potz'	ball
Bambara	Bambara
ankane'y	banana
uchi'	band
poq'ik	bang
ja k'olpwaq	bank
bar	bar
k'ate	barely
uqasaxik rajil	bargain
tyo'nik	bark
tyo'nem	bark
uraqik chi'aj	bark
seb'ad	barley
q'ateb'al	barrier
uxe'al	base
petinaq chech	based
uxe' ja	basement
qas kachokonik	basic
qas jewi	basically
albahaca	basil
b'anal etzelal	bastard
juperaj	batch
ch'ajo'nib'al	bath
eleb'al	bathroom
k'olq'aq'al	battery
ch'o'jinem	battle
utza'm ulew	bay
k'olem	be
utz rilik kb'anik	be careful
uchi' polow	beach
juxk'inem	beam
kinaq'	beans
uya'ik	bear
uch'ijik	bear
ya'onem	bear
uk'amik	bear
k'amonem	bear
chajinem	bear
ismachi'	beard
na'ojinem	bearing
Nim chikop	beast
q'ojom	beat
uq'osixik	beat
uch'akik	beat
b'anik	beat
ch'a'ik	beat
je'lik	beautiful
petib'al	beauty
xintzalijik	became
rumal	because
tzalijem	become
ch'at	bed
warab'al	bedroom
wonon	bee
ti'ij	beef
b'anowinaq	been
tzam	beer
mojo'qa che	before
xinmajij	began
umajik	begin
majib'al	beginning
rech ri	behalf
utz no'jinem	behave
no'jib'al	behavior
no'jib'al	behaviour
chi rij rech	behind
are taq	being
kojonb'al	belief
kojonik	believe
pamaj	belly
rech are'	belong
loq'olaj	beloved
chi uxe'	below
ximob'al	belt
che' t'uyulb'al	bench
uq'ochik	bend
chi uxe' rech	beneath
tob'anem	benefit
pataninik	benefit
tob'anik	benefit
pataninem	benefit
ri kaya'ik	benefits
rachi'l	beside
xuquje'	besides
qas utz	best
sib'alaj k'o ch'akanem	best of luck
ruk' k'ixb'al	best regards
qas utz	better
chi uxo'l	between
uk'ya'	beverage
k'a jela'	beyond
Bhojpuri	Bhojpuri
qas kajawatajik	bias
k'o uq'ijol	biased
let'et'	bicycle
utzujuxik	bid
nim	big
let'et'	bike
uwujil tojonik	bill
jat'inem	bind
tz'ikin	bird
utz'aqatisaxik junab'	birthday
jutz'it	bit
qarinem	bite
kayenem	bite
tojonem	bite
qarinik	bite
kayenik	bite
tojonik	bite
k'a	bitter
q'eq	black
uxaq	blade
uya'ik ub'ixik che	blame
uya'ik ub'ixik	blame
ub'anik makaj	blame
makaj	blame
pa saqil	blank
q'u'aj	blanket
kaqulja	blast
b'anb'al saqilal	bleach
uyujik	blend
tewechib'al	bless
tewechi'talik	blessed
moy	blind
ki'kotemal	bliss
kaxlan xan	block
kik'	blood
kotz'i'j	bloom
uxut'ixik	blow
raxkaj	blue
man b'anom ta uware	blunt
tz'alam	board
nim jukub'	boat
ch'akul	body
upoq'owsaxik	boil
chaqab'	bold
kolob'	bond
b'aq	bone
tz'ajanik	book
tzajb'al wuj	book
wuj	book
uk'olik	book
chuch wuj	book
wa'lijisanem	boost
paqab'anem	boost
upaqab'axik	boost
wa'lijisaxik	boost
uya'ik uchuq'ab'	booster
b'otax	boot
taq b'otax	boots
monjon	border
q'itajik	bore
maj karaj kub'ano	bored
k'o ta kraj kub'ano	boring
alaxinaq	born
uqajik	borrow
k'amal b'e	boss
kab'ichal	both
ub'anik etz'anem	bother
lame't	bottle
wachretal	bottom
xinloq'o	bought
upixk'ansaxik	bounce
taqchital ub'anik	bound
monjon	boundaries
pachalem	bow
b'as	bowl
kajxkut	box
ak'al	boy
k'ulaj	boyfriend
qulq'ab'	bracelet
tzantzaq'or	brain
uq'ab'il	branch
retal	brand
k'an	brave
q'ajq'ob'em	breach
kaxlan wa	bread
upaxixik	break
ri q'atb'altzij	break
uxlanik	break
uxlanem	break
wa rech nimaq'ab'	breakfast
uwach k'u'xaj	breast
uxlab'	breath
ujek'ik kaqiq'	breathe
upetib'al	breed
porom xan	brick
k'ulaj	bride
q'axeb'al	bridge
xaq ko'lik	brief
sib'alaj katz'ajlinik	bright
kachuplinik	brilliant
uk'amik loq	bring
achalal	bro
uwach	broad
uq'axexik apanoq	broadcast
paxim	broke
paxinaq	broken
meseb'al	broom
achalal	brother
b'aluk	brother in law
nim atz'yaq	brought
kape	brown
ujosq'ixik ware'aj	brush
kwet	bucket
achi'l	buddy
urajilal chak	budget
q'upunel	bug
uwokik	build
nim ja	building
wokotalik	built
eqa'n	bulk
ama' wakax	bull
ub'anik bully	bully
tzaqem	bump
racimo	bunch
eq'an	bundle
eqa'n	burden
reqaxik	burden
k'olq'aq'al	burden
muqum	buried
poroxik	burn
puk'inem	burst
umuqik	bury
ch'ich' ereb'al winaq	bus
b'e'nche'	bush
k'ayinem	business
wachib'al	bust
man jamal ta uwach	busy
xa k'ut	but
manteka'	butter
pepe	butterfly
pitz'b'al	button
loq'ik	buy
rumal	by
xa k'u cha'	by the way
jeb'a'	bye
repo'y	cabbage
k'olib'al jastaq	cabinet
ko'k	cage
ch'uch'uj kaxlanwa	cake
upa'a'	calf
ch'awem pa ch'aweb'al	call
ch'awik	call
sik'inem	call
ub'ixik	call
sik'inik	call
b'ixik	call
chinach'ab'ej	call me
xinsik'ij apanoq	called
eye'nem	calm
impetinaq	came
yaktzijol	campaign
kowinik	can
kowinem	can
chuq'ab'enik	can
tqanik	can
taqanem	can
chuq'ab'il	can
man kb'an ta kowinem	can't
Uq'atexik	Cancel
q'aynaqil yab'il	cancer
kowinem	capable
kuch'ijo	capacity
nim tinamit	capital
ral k'utb'al q'atoj	caption
uchapik	capture
ch'ich'	car
tijowanim	career
no'jimalil	careful
no'jimal	carefully
man ilom taj	careless
ajloq'	caring
ajanel	carpenter
upopil upaja	carpet
q'anichaj zanja	carrot
uk'amik b'ik	carry
terne'xik	carry on
kb'an na	carry out
kaso	case
ruk' pwaq	cash
uwinaqil	cast
tz'u'q ja	castle
kub'ana wi na	casual
me's	cat
chapanik	catch
ub'antajik	category
awajib'	cattle
xinchapo	caught
b'anoj	cause
jas che	cause
k'ulmatajem	cause
k'ulmatajik	cause
ub'anik	cause
q'ilb'al	caution
kuchajij rib'	cautious
pek	cave
ujamarisaxik	cease
uwi ja	ceiling
uya'ik una'tajisaxik	celebrate
k'ajk'as	cell
uk'u'x	center
ab'	century
t'orotaq ija'	cereal
nimaq'ij	ceremony
tzij	certain
qas tzij wi	certainly
uya'ik utz'ib'axik	certificate
k'amchachal	chain
tem	chair
kb'an na	challenge
chak	chance
uk'exik	change
sachem	chaos
winaqil	character
taq ub'antajik	characteristics
uya'ik	charge
tob'anem	charity
b'anal mayijab'al	charming
kajxukut	chart
uterne'xik	chase
tz'ib'anik	chat
tzijonem	chat
tz'ib'anem	chat
tzijonik	chat
man paqal ta rajil	cheap
ub'anik tzij	cheat
b'anoj k'ax	cheating
rilik yab'il	check
uk'amb'ejaxik	check
rilik	check
palaj	cheek
usilab'axik	cheer
tze'tzotem	cheerful
utzwachil	cheers
Keso	cheese
eta’mab’alil tz’aqatil jastaq	chemistry
retwechixik	cherish
ajedrez	chess
uwach k'u'xaj	chest
kach'unem	chew
ak'	chicken
k'amal b'e	chief
ak'al	child
ak'alal	childhood
ak'alab'	children
xut'inem	chill
q'aq'tewal	chill
k'o ta kb'anik	chill
jorob'sanem	chill
releb'al taq sib'	chimneys
kakte'	chin
kab'	chocolate
cha'onem	choice
ucha'ik	choose
pa'inem	chop
b'anoj	chores
alaj chom	chubby
tyox ja	church
kanel	cinnamon
ketekik	circle
jastaq	circumstances
winaqil	citizen
tinamit	city
uya'ik uch'a'ik	claim
usuk'ub'axik ub'ixik	claim
uch'a'ik	claim
ajawanem	claim
uq'alajisaxik	clarify
b'antajik	class
kach'ulew	clay
ch'ajch'oj	clean
q'alaj	clear
uq'alajisaxik	clear
kq'alajin upam	clear
t'iqitalik	clerk
utz chik	clever
loq'omanel	client
swan	cliff
miq'tewal ulew	climate
paqalem	climb
suk'umam	clingy
etal q'ij	clock
utz'apixik	close
k'olib'al atz'yaq	closet
taq atz'yaq	cloth
atz'iyaq	clothes
sutz'	cloud
sutz'	cloudy
ajyakol tze'	clown
etz'anib'al	clue
xaq katzaqik	clumsy
kluster	cluster
tijonik	coach
ajtij	coach
tijonel	coach
aq'a'l	coal
taq'aj	coast
pim atz'yaq	coat
kape	coffee
k'oxomanem	cognitive
k'oxomab'al	coincidence
tew	cold
tzaqik	collapse
chachal	collar
achi'l	colleague
achi'l	colleagues
umulixik	collect
ucha'ik	collection
nim tijob'al	college
tz'ajb'al	color
ri rax taq na'oj man kel ta utz'ajb'al utzalaj waram kkib'ano	colorless green ideas slept furiously
tz'ajb'al	colour
tak'al juch'	column
uxiyik wi'aj	comb
uyujik	combination
uxo'laxik	combine
petem	come
tojo waral	come here
jo'	come on
utzalaj k'olem	comfort
sib'alaj utz	comfortable
jun chik	coming
petinaq aq'anoq	coming soon
taqanik	command
utzijoxik rij	comment
k'aywokaj	commercial
tojb'alil	commission
ub'anik	commit
rajawaxik kb'anik	commitment
uya'om uchi'	committed
utz k'owi	commodity
k'o uch'a'ik	common
tzijonem	communicate
tzijonem	communication
wokaj	community
b'yajem pa ri chak	commute
achi'l	companion
k'aywokaj	company
ujunamaxik	compare
ujunamaxik	comparison
toq'ob'sanem	compassion
k'o ukoch'onik	compassionate
uk'ulaj rib'	compatible
uterne'xik ch'akanem	compete
qas ka'ilowik	competent
riqonem	competition
kraj kch'akanik	competitive
uya'ik uch'a'ik	complain
uch'a'ik	complaint
tz'aqatenem	complement
tz'aqatil	complement
utz'aqatisaxik	complement
ya'onem	complement
utz'aqatisaxik	complete
tz'aqatem	completely
k'ax	complex
uya'ik uch'a'ik	compliance
k'ax uchomaxik	complicated
tz'aqatisam	compliment
utz'aqatisaxik	comply
utz'ib'axik	composition
b'anom k'aj che	compound
ch'ob'onem	comprehension
tz'aqat	comprehensive
k'ulanem	compromise
rajawaxik kb'anik	compromise
uya'ik ub'ixik che tzij rajawaxik kb'anik	compromise
qas rajawaxik wi	compulsory
kematz'ib'	computer
ukojik chomanem	concentrate
ri kub'ij	concept
ukojik	concern
mayowem	concern
mayowik	concern
petinaq chech	concern
kmayowik	concerned
q'ojomanem	concert
uk'isb'alil	conclusion
qas are'	concrete
tz'aqatisaxik	concrete
qas tzij	concrete
tz'aqatisam	concrete
kajawataj chech	condition
taqanem	conditions
no'jinem	conduct
tzijonem	conference
uq'alajisaxik	confess
uq'alb'al k'u'x	confidence
k'o uch'ijb'al	confident
usuk'ub'axik	confirm
ch'a'oj	conflict
man kuch'ob' ta ub'anik	confused
sachem	confusion
ki'kotemal awech	congrats
uya'ik kikotemal	congratulation
utz awech	congratulations
nuk'ik	conjunction
ut'iqik	connect
ub'ochi'xik	conquer
k'o uk'oxomab'al	conscious
kch'omanik	consciousness
ya'ik	consent
k'olem ruk' chi winaq	consent
uya'ik b'e	consent
k'olik	consent
umak	consequences
utasik apanoq	conservation
k'olonel	conservative
uch'ob'ik	consider
xinch'ob'o	considered
ruk'a'am	consist
junamil	consistency
k'o uk'oxomab'al	consistent
amaq'el	constant
amaq'el	constantly
q'ululem pamaj	constipation
uwokik	construction
utijik	consume
ukojik	consumption
chapanik	contact
ajch'ab'e'n	contact
uch'ab'exik	contact
chapanem	contact
koqanik	contagious
ruk'a'am	contain
ruk'a'am	contains
kamik	contemporary
itzel kaye'nem	contempt
upam chak	content
opanriqonem	contest
upam chak	context
continente	continent
ub'anik na	continue
uchokik	contract
chak patan	contract
k'amuq'ab'	contract
uq'alajilal	contrast
ukojik q'eqsaqilal	contrast
qeq'saqilal	contrast
saqil	contrast
tob'anem	contribute
tob'anem	contribution
rilik	control
ch'o'jinem	controversial
ri karaj	convenience
are tzu che	convenient
tzijonem	conversation
jalk'atinik	convert
jalk'atinem	convert
q'axexik	convert
q'axenem	convert
ub'ixik	convey
ukojik upam	convince
uch'akom che ranima	convinced
unuk'maxik	cook
ub'anik wa'	cook
nuk'maxik	cook
b'anal wa	cook
b'anb'al wa	cooking
uq'alb'al k'u'xaj	cool
utz	cool
jororem	cool
sib'alaj utz	cool
maj jewi	cool
ujorob'asaxik	cool
tob'anem	cooperation
uxalq'atixik	cope
kaqakach’ch’ich’	copper
uk'u'xal	core
ixim	corn
xukut	corner
qas tzij	correct
rajilal	cost
k'ax ub'anik	cost
atz'yaq	costume
alaj ja	cottage
b'ot	cotton
nima tem	couch
qulaj	cough
wene	could
na'oj	council
rajilaxik	count
k'utb'al	counter
amaq'	country
k'olib'al	countryside
k'ulajil	couple
kowinem	courage
eta'manem	course
q'atb'altzij	court
k'o uk'ixb'al	courtesy
ch'utiwachalal	cousin
uchuq'ik	cover
wakax	cow
man kuk'ut ta rib'	coward
sib'alaj utz	cozy
tap	crab
paxe'l	crack
paxixik	crack
paxinem	crack
manualidad	craft
achaq	crap
paqchixik	crash
paqchinem	crash
paq'inem	crash
paq'ixik	crash
munil	craving
chakanem	crawl
pay	crazy
uwinaqirisaxik	create
k'o uchomab'al	creative
qajanem	credit
chararexik	creep
xib'ib'al	creepy
winaqil	crew
makaj	crime
pachalik	cringe
xib'in ib'	cringe
rech k'ixb'al	cringe
xib'inik	cringe
wi'jal	crisis
ub'antajik	criteria
kaxk'olil	critical
ucha'ik rij	criticism
tiko'n	crop
taq tiko'n	crops
q'axem	cross
kruz	cross
q'axenik	cross
ok'owem	cross
joj	crow
uk'iyal winaq	crowd
kub'ana ta chik	crowded
q'alwach	crown
pa'italik	crucial
sib'alaj k'ax	cruel
wa'katem	cruise
uwach'ik	crush
chapik	crush
k'iyal	crush
wachik'ik	crush
k'iyanik	crush
pach'anik	crush
upach'ik	crush
oq'ej	cry
pepin	cucumber
matzexik	cuddle
b'antajik	culture
kub'an wi	cunning
alaj xa'r	cup
k'ayib'al	cupboard
uchi'	curb
ukunaxik	cure
rilik	cure
ukunab'alil	cure
kunanem	cure
kunanik	cure
ramaj rech man kb'an ta elem	curfew
kraj kareta'maj	curiosity
karaj reta'maxik	curious
Koloch	curly
ch'ich' pwaq	currency
kamik	current
kamik	currently
itzelal	curse
atz'yaq ch'uqsaqil	curtain
alaj tem	cushion
naq'tisam ub'anik	custom
loq'omanel	customer
taq uqajb'al xik'ich'ich'	customs
sokotajik	cut
raminem	cut
sokotajem	cut
ramixik	cut
je'lik	cute
k'utunsanwachib'al	cycle
cholkejen ch'ich'	cycling
tat	dad
tat	daddy
chi q'ij	daily
uwa'l tu'	dairy
tapya	dam
ub'anik k'eyowal	damage
ub'anik k'ax	damage
kaxk'ol	damn
raxqinilik	damp
xojowem	dance
kub'an k'ax	danger
rech k'axk'ol	dangerous
q'equ'm	dark
loq'alaj	darling
rab'juch'	dash
rajilb'alil q'ij	data
sik'inem	date
rajilb'alil q'ij	date
uq'ijol	date
mi'al	daughter
q'ij	day
kaminaq	dead
uk'isb'al q'ij	deadline
tokon	deaf
uya'ik	deal
uchomaxik	deal
ri uya'ik	deal
ri k'amuq'ab' chak	deal
chomanem	deal
loq'alaj	dear
Loqalaj	Dear All
Loq'olaj loq'omanel	Dear Customer
Loq'alaj taq tat nan	Dear Parents
Loq'alaj Tat	Dear Sir
Loq'alaj taq tijoxelab'	Dear students
Loq'alaj taq wokaj	Dear Team
kamikal	death
uch'ojimaxik	debate
k'asaj	debit
utz'aqat	debris
k'asaj	debt
q'ijol	decade
teq'etob'ik	decay
kaminaq	deceased
ub'anik tzij	deceive
ukab'laj ik'	december
suk'	decent
uchomaxik	decide
xinchomaj	decided
chomanem	decision
ropanib'al jukub'	deck
man kyta ta b'e	decline
unitz'arisaxik	decrease
qas uchakum	dedicated
qajnem	dedication
tz'ib'	deed
nim qajinaq	deep
masat	deer
pacha' ya'om loq	default
b'anom	defeat
uriqik	defeat
ub'anik	defeat
uriqik k'ax	defeat
uto'ik	defend
rilik	define
junelik wi	definitely
kel kub'ij	definition
tan	degree
rech kutan	delay
b'eyonem	delay
b'eyik	delay
elenaq kanoq	delayed
uchupik	delete
uchomaxik	deliberate
ch'in	delicate
utz una'ik	delicious
placer	delight
nim karil wi	delighted
uya'ik	deliver
ya'om	delivered
rech uya'ik	delivery
uch'ojixik	demand
chokonem	demand
ukojik tzij	demand
chokonik	demand
kuch'a'o	demanding
tzoqopinem	democracy
itzel uxlab'al	demon
uk'utunsaxik	demonstrate
ya'om ta b'e chech	denied
unimal	density
ilol ware'aj	dentist
man kya ta b'e	deny
nim tinamit	department
elem	departure
kajawataj na jun	depend
uq'axexik	deploy
uya'ik	deposit
ya'onem	deposit
k'ayib'al jastaq	deposit
ya'onik	deposit
k'olib'al	deposit
q'itajinaq	depressed
swan	depression
nim upam	depth
uya'ik usaqil tzij chi rij	describe
uq'alajisaxik	description
tz'inilik ulew	desert
qas uch'akom	deserve
petik	design
uwokik	design
petib'al	design
wokob'al	design
ub'i'	designation
kwaj	desire
ajawatajik	desire
ajawanem	desire
mexa	desk
desesperación	despair
karaj taj jas kub'ano	desperate
ruk' taq ri	despite
k'olib'al katz'inowik	dessert
ropanib'al	destination
opanib'al	destiny
uwulixik	destroy
uwulixik	destruction
ucholajixik	detail
taq cholajil	details
rilik	detect
rilik	determination
rilik	determine
ilom	determined
yujum uk'aslemal	devastated
uya'ik ub'ixik	develop
b'anom ub'anik	developed
uwa'lijisaxik uwach	development
wiqkemchakub'al	device
itzel	devil
b'anom toq'ob' che	devoted
Dhivehi	Dhivehi
ki'arik kik'	diabetes
torotajem pamaj	diarrhea
chi q'ij	diary
choltzij	dictionary
xinb'ano	did
kamik	die
kaminaq	died
chatal wa'im	diet
uk'exb'alil	difference
jalan wi	different
k'ax	difficult
uk'otik	dig
loq'ob'al aq'anoq	dignity
kojom	diligent
wa rech b'enaq q'ij	dinner
pix	dip
uk'amik b'e	direct
achochib'al	direction
k'amal b'e	director
tz'il	dirt
tz'il	dirty
uya'ik kan yab'yoj	disable
yab'yoj	disabled
sachanem	disappear
man utz ta rilom	disappointed
k'eyowal	disaster
relesaxik	discard
uya'ik relem b'ik	discharge
taqanem	discipline
uqasaxik rajilal	discount
uriqik	discover
retzelaxik	discrimination
uch'a'ik	discuss
tzijonem	discussion
yab'il	disease
taq yab'il	diseases
patzka'rem	disguise
tzel una'ik	disgusting
rikil	dish
taq wa'b'al	dishes
relesaxik b'ik	dismiss
utaqik	dispatch
uk'utunsaxik	display
maj upatan	disposal
ch'a'oj rij	dispute
uxo'l	distance
jalan wi	distinct
ujachik uwach	distinguish
q'oxowem	distress
ujachik	distribution
k'olib'al	district
uq'atik	disturb
ub'e ja'	ditch
puq'inem	dive
jalajoj	diverse
jalajoj uwach	diversity
upa'ixik	divide
maj jewi	divine
jachanem	divorce
jachanik	divorce
muluw k'u'x	dizzy
ub'anik	do
at	do you
kinawaj	do you love me
ajkun	doctor
wuj	document
b'anik	does
ja'i'	doesn't
tz'i'	dog
Dogri	Dogri
ktajin ub'anik	doing
ala's	doll
rajaw kemk'at	domain
chi uwaja	domestic
are qas kb'an rech	dominant
ja'i'	don't
Man k'o ta kamayo	Don't worry
usipaxik	donate
b'anom chik	done
b'ur	donkey
q'ayes	dope
kamulim	double
ukamulixik	double
keb' uwach	double
mayowem	doubt
mayowik	doubt
q'or	dough
chi uxe'	down
uqasaxik	download
chupb'al	draft
machot	draft
ub'anik jun chuptz'ib'	draft
alaj chuptz'ib'	draft
uchararexik	drag
ub'e joron	drain
drama	drama
utz'ajik	draw
kaxon	drawer
tz'ajanik	drawing
xib'in ib'	dread
kraj kub'an jun q'ij	dream
achik'ik	dream
waram	dream
karatz'yaqisaj rib'	dress
worob'al	drill
qumuxik	drink
qumunik	drink
uk'ya'	drink
utijik jastaq	drink
ub'inisaxik ch'ich'	drive
tz'uj	drop
uya'ik tzaqik	drop
elesam kanoq	dropped
chaqijorem	drought
q'ab'arel	drunk
chaqi'j	dry
patax	duck
ub'antajik	dude
rumal	due
rumal che	due to
nim taj	dull
kchob'on taj	dumb
k'olb'al mes	dump
uq'ijol	duration
are taq	during
ulew	dust
rajawaxik kb'anik	duty
k'olem	dwell
kosib'al	dying
chi	each
chi jujun	each other
kraj kub'ano	eager
xik	eagle
xikin	ear
sib'alaj aq'ab'il	earlier
aq'ab'il	early
uch'akik	earn
taq xikin	ears
uwachulew	earth
nim keb' raqan	earthquake
man k'ax ta ub'anik	ease
man k'ax taj	easily
releb'al q'ij	east
man k'ax taj	easy
wa'ik	eat
wa'ik	eating
meb'a'il	economic
meb'a'il	economy
chi uchi'	edge
uk'exsuk'umaxik	edit
tijonem	education
mayib'al	effect
qas utz	effective
sak'aj	efficiency
qas utz	efficient
ukojik chuq'ab'	effort
saqmo'l	egg
q'eqichaj	eggplant
nimal	ego
wajxaqib'	eight
wajxaqlajuj	eighteen
jumuch'	eighty
on	either
unuk'maxik	elaborate
ch'u'kaj	elbow
ri'j winaq	elder
nim winaq	elderly
je'lik	elegant
tz'aqatil	element
tix	elephant
julajuj	eleven
utz kacha'ik	eligible
uchupik	eliminate
nik'aj chik	else
kak'ixik	embarrassed
k'ixb'al rilik	embarrassing
laq'apuxik	embrace
mub'anem	emerge
aninaqil rij	emergency
nab'alil	emotional
tob'anem	empathy
chuq'ab'ib'al	emphasis
chuq'ab'ixik	emphasize
ajchak	employee
ajchakib'	employees
k'aywokaj	employer
chak	employment
jamal upam	empty
jamal uwach	enable
uriqik	encounter
ukojik chuq'ab'	encourage
uk'isb'al	end
k'o pa k'eyowal rech uchupik uwach	endangered
chuq'ab'il	endeavor
uchijkil	endurance
ukolik k'aslemal	endure
k'ulel	enemy
kaxlan q'aq'	energy
uya'ik ub'ixik che kb'anik	engage
kub'an wi	engaged
rajawaxik kb'anik	engagement
yab'al uchuq'ab'	engine
ajpuqno'jib'al	engineer
Inglés	English
ub'anik utz che	enhance
ki'kotem	enjoy
sib'alaj nim	enormous
ke'ub'ana'	enough
utz rilik kb'anik	ensure
okem	enter
naq'tisaxik	entertainment
entusiasmo	enthusiasm
ki'kotem	enthusiastic
tz'aqat	entire
kojom ub'i'	entitled
wokaj	entity
okib'al	entrance
Nimalaj ajk'ay	entrepreneur
chi rij	envelope
ulewal	environment
ti'tikil	envy
maj jewi	epic
suqyab'il	epidemic
junam	equal
chakub'al	equipment
q'inomalil	equity
junam	equivalent
chuptz'ib'	eraser
sachem	error
elem b'ik	escape
qas are'	especially
te'taliknem	essay
uk'u'x	essence
qas rajawaxik wi	essential
ukojik	establish
kojom	established
ub'antajik	estate
retwechixik	estimate
loq'alaj	estimated
nik'aj chik	etc
junelik	eternal
ética	ethics
uk'amb'ejaxik	evaluate
upajik rij	evaluation
pine'	even
pine' are taq	even though
chaq'ab'	evening
k'ulmatajem	event
chi jantaq	eventually
k'o jumul	ever
chi	every
ronojel	everybody
konojel	everyone
amaq'el	everything
b'anoj	evidence
itzel	evil
k'extajem	evolution
uk'exik	evolve
Ewe	Ewe
ex	ex
jela'	exact
je k'u la'	exactly
k'amb'ejanem	exam
utzukuxik	examine
k'amb'ejab'al tzij	example
q'axnaq chik	exceed
sib'alaj utz	excellent
ruk' we	except
man chi'l taj	exception
q'axnaq chik	excess
sib'alaj kaq'axik	excessive
k'exonem	exchange
ki'kotem rech	excited
na'b'alil	excitement
sib'alaj ki'kotemal	exciting
xew rech	exclusive
tzukum tzij	excuse
kuyu'	excuse me
uchakuxik	execute
uchakuxik	execution
Nim reqele'n	executive
b'anik	exercise
chak patan	exercise
unaq'tisaxik ub'anik	exercise
uk'isik	exhaust
kosinaq	exhausted
uya'ik apanoq	exhibit
uk'utik	exhibition
k'olik	exist
k'olik	existence
k'o chik	existing
eleb'al	exit
unimarisaxik	expand
reye'xik	expect
ktajin reye'xik	expected
uchupurik pwaq	expenses
paqal rajil	expensive
k'o reta'mab'al	experience
eta'manem	experience
rilik uta'ik	experience
reta'maxik	experience
ktajin rilik	experiment
ajsaqwachom	expert
k'isnaq uq'ijol	expired
uq'alajisaxik	explain
uya'ik uq'alajisaxik	explanation
unik'oxik	exploit
unik'oxik	explore
utaqik b'ik	export
uya'ik ub'ixik	expose
ya'om apanoq	exposed
uq'alajisaxik	exposure
aninaqil	express
ub'ixik	expression
unimarisaxik	extend
nimarisam	extended
raqan uq'ab'	extension
uq'ab' utza'm	extent
elenaq b'ik	external
k'o ta chik	extinct
extra	extra
relesaxik	extract
maj jewi	extraordinary
utza'm	extreme
sib'alaj	extremely
b'aqwachaj	eye
b'aq'wachaj	eyes
atz'yaq	fabric
sib'alaj je'lik	fabulous
cholk'aslemal	face
palaj	face
ub'ixik chi upalaj	face
uya'ik	facilitate
ukojik	facilities
jeqeb'anem	facility
makaj	fact
ajalib'al	factor
wokob'al	factory
taq b'anoj	facts
uq'oq'otexik	fade
k'ax	fail
ub'anik k'ax	fail
man xkowinb'ex ta ub'anik	fail
xinsachik	failed
man utz ta ub'anom	failure
sutinwachaj	faint
utza pajb'al	fair
q'alaj	fair
utz uk'aslemal	fair
suk'	fair
suk'	fairly
ada	fairy
kojb'al	faith
suk'	faithful
man je taj	fake
q'ajik	fall
tzaqem	fall
qajem	fall
tzaqik	fall
man itz ta rilik	fall
MAN TZIJ TAJ	FALSE
k'o uch'a'ik	fame
ajupaja	familiar
ajupaja	family
k'o numik chaqij chi'	famine
k'o uch'a'ik	famous
xut'ib'al	fan
utz upetik	fancy
maj jewi	fantastic
naj	far
uk'isb'alil	farewell
awajib'al	farm
ilol awajib'	farmer
je'l upetik	fascinating
moda	fashion
aninaq	fast
chom	fat
sib'alaj k'ax	fatal
ropanib'al	fate
tat	father
kosem	fatigue
karaj na	fault
ajawatalik	favorite
jun toq'ob'	favour
ajawatalik	favourite
paqab'anem	fear
upaqab'axik	fear
b'anik	fear
xib'in ib'	fear
kraj taj kub'ano	fear
nimaq'ij wa'im	feast
rismal awaj	feather
petik	feature
k'utunsanem	feature
ub'antajik	feature
petem	feature
uk'utik	feature
k'utunsanik	feature
ub'antajik	features
ukab' ik'	february
ya'om uwa	fed up
rajilal	fee
utzuqik	feed
kamul uk'utik	feedback
na'ik	feel
na'b'alil	feeling
aqan	feet
tzaqik	fell
achi'l	fellow
xin na'o	felt
ixoq	female
koral	fence
utz kb'an tiko'nijik	fertile
nimaq'ij	festival
uk'amik loq	fetch
q'aq'	fever
k'i taj	few
man k'i taj	fewer
uya'om uchi'	fiance
man tzij taj	fiction
uqajb'al	field
b'anal k'ax	fierce
jo'lajuj	fifteen
kawinaq lajuj	fifty
ch'a'ojinem	fight
uwa'lijisaxik uwach	fight
ukojik chuq'ab'	fight
ch'a'ojinik	fight
ch'a'oj	fighting
ajilab'al	figure
ukojik rajilal	figure
unimal	figure
pwaq	figure
usolik uwach	figure out
kemk'olib'al	file
unojisaxik	fill
nojisab'al rech	filled
k'olsilob'wach	film
tzel rilik	filthy
chi uk'isb'al	finally
upetik ameb'a'il	finance
pwaqilal	financial
uriqik	find
usolik uxe'	find out
utz	fine
q'atoj tojonik	fine
kachokonik	fine
ch'uch'uj	fine
uwi q'ab'aj	finger
uk'isik	finish
k'isom	finished
q'aq'	fire
tak'alib'al	firm
ujuch'ik	firm
suk'	firm
juch'b'i'aj	firm
nab'e	first
nab'e b'i'aj	first name
kar	fish
kub'ano	fit
job'	five
ub'anik rutzil	fix
jeqom	fixed
etal atz'yaq	flag
jumul usachanik	flash
ja k'olib'al	flat
li'anik	flat
liya'nik	flat
uk'uwachib'al ri ja	flat
k'utwachinik	flat
k'o k'ax che	flaw
maj jewi	flawless
animajem	flee
ti'ij	flesh
xinxik'ik'ej	flew
utz ukotik	flex
man ko taj	flexible
b'enam pa xik'ich'ich'	flight
uya'ik sutinem	flip
k'aqa't	flirt
k'aqa't	flirting
li'owem	float
mub'anik	flood
tan	floor
k'aj	flour
utijik anim	flow
kotz'i'j	flower
yab'il jolomaj	flu
utz ub'inem	fluent
ruk' uq'alajilal	fluently
k'o rismal	fluffy
b'inel	fluid
xik'ik'ik	fly
unik'ajal	focus
rilik	focus
muqulik sutz'	fog
sutz'	foggy
unutik	fold
taq achi'l	folks
uterne'xik	follow
uterne'xik	follow up
jun chik	following
rikil	food
ub'anik tzij	fool
pay	fool
pay	foolish
raqan	foot
retz'ab'exik potz'	football
chech	for
k'amb'ejab'al tzij	For example
k'amb'ejab'al tzij	for instance
chi awech	for you
man ya'om ta b'e che	forbidden
chuq'ab'	force
uya'ik ub'ixik apanoq	forecast
chi uwach	forehead
rech jun chi tinamit	foreign
k'ache'laj	forest
junelik	forever
usachik	forget
ukuyik makaj	forgive
xinsacho	forgot
ixk'eqwab'al	fork
petik	form
petib'al	form
nojisab'al wuj	form
ub'antajik	form
unuk'maxik	form
retal	formal
jun kanoq	former
we k'o ch'akanem	fortunately
meb'a'il	fortune
kawinaq	forty
kawinaq keb'	forty-two
chi uwach	forward
k'amik rij	foster
ch'a'oj	fought
xinriqo	found
utikitajik	foundation
kajib'	four
kajlajuj	fourteen
par	fox
kq'ajik	fragile
kajxukut	frame
framework	framework
elaq'	fraud
man qas ta kaya'tajik	freak
sipatalik	free
tzoqopim	freedom
ut'ajajarisaxik	freeze
chi jantaq	frequency
amaq'el	frequent
amaq'el	frequently
k'ate ub'anik	fresh
uro' q'ij	friday
t'ajajarisab'al	fridge
achi'l	friend
kub'an achi'l	friendly
taq achi'l	friends
achi'l	friendship
uxib'im rib'	frightened
k'ax rilik	frightening
ixtutz'	frog
rech	from
chi uwach	front
t'ajajirisam	frozen
uwach che'	fruit
uriqom k'ax	frustrated
uja'al ch'ich'	fuel
Fulfulde	Fulfulde
nojinaq	full
ki'kotem	fun
uchak	function
qas kachokonik	fundamental
muqb'al	funeral
tze'b'al	funny
wi'aj	fur
k'anarinaq	furious
taq jastaq	furniture
nik'aj chik	further
xuquje'	furthermore
petinaq aq'anoq	future
ch'akik	gain
riqonem	gain
uriqik	gain
ch'akoj	gain
etz'anem	game
q'a'am	gap
k'olib'al ch'ich'	garage
mes	garbage
chikopb'al	garden
anxux	garlic
uchija	gate
umulixik	gather
umulixik chi jumul	gathering
retaxik	gauge
b'ij	gave
wokaj	gear
ub'antajik	gender
chi ronojel	general
chi ronojel wi	generally
uwinaqirisaxik	generate
b'antajem	generation
sipanel	generous
k'o reta'mab'al	genius
b'antajik	genre
tob'anel	gentle
qas tzij	genuine
memal	gesture
uriqik	get
ukojik atz'yaq	get dressed
wa'lijem	get up
aninaq ta b'a' katkunatajik	get well soon
ktajin uriqik	getting
xib'inel	ghost
xib'inel wachib'al	ghosting
sib'alaj nim raqan	giant
sipanik	gift
xenxi'p	ginger
ali	girl
k'ulajil	girlfriend
uya'ik	give
k'olem kanoq	give up
ya'om	given
kki'kotik	glad
rilik	glance
b'as	glass
ilwach	glasses
rilik	glimpse
chi ronojel	global
kb'isonik	gloomy
tasb'al q'ab'aj	gloves
uq'alajilal	glow
q'apowik	glow
uq'apowil	glow
saqilal	glow
rapq'inik	glow up
nak'b'al	glue
b'enam	go
chi uwach	go ahead
jat	go away
q'oyolem	go to bed
opanib'al	goal
taq riqonem	goals
k'isik'	goat
ajaw	god
are ri ajawixel kattewechi'nik	god bless you
b'enam	goes
b'enam	going
b'anem pa	going to
q'an pwaq	gold
b'enam	gone
b'enam pa	gonna
k'axaj	goo
ajloq'	good
sib'alaj je' ub'anik	good
utz	good
je'l upetik kaloq'onik	good
sib'alaj utz	good
utz ranima	good
utz una'oj	good
xb'e q'ij	good afternoon
jeb'a'	good bye
utzalaj q'ij	good day
xokaq'ab'	good evening
utzalaj chak	good job
kajunamatajik	good looking
utz ta b'a' xub'ano	good luck
saqirik	good morning
saqirik nuloq'ob'al	good morning my love
xokaq'ab'	good night
jeb'a'	goodbye
xokaq'ab'	goodnight
jastaq	goods
Google	Google
Q'axeb'al tzij rech Google	Google Translate
yuq patax	goose
je'lik	gorgeous
ajaltzijol	gossip
uriqik	got
kinch'ob'o	got it
ajpop	government
uchapik	grab
tan	grade
xa kapaqi'k	gradually
ch'akanem	graduate
t'orota'q ija'	grain
uya'ik	grant
ya'om	granted
taq ki't'ub'	grapes
rok'onem	grasp
q'ayes	grass
kmaltyoxinik	grateful
tyoxinem	gratitude
jul kaminaq	grave
saqsoj	gray
je'lik	great
rayib'al k'u'xaj	greed
xu'y	greedy
rax	green
uya'ik utz petem	greet
rutzil wachaj	greeting
rutzil wachaj	greetings
q'eqq'oj	grey
kajxukut	grid
k'axk'ol	grief
uke'xik	grind
chapanem	grip
k'ayib'al jastaq	grocery
k'ulaj	groom
pay	gross
uwachulew	ground
wokaj	group
k'iyem	grow
k'iyem	growth
k'a'n	grumpy
Guarani	Guarani
uya'b'al q'alb'al k'u'xaj	guarantee
chajinel	guard
uch'akik	guess
sik'italik	guest
k'utub'e	guidance
k'amb'al cholajil	guide
k'amal b'e	guide
uk'amik b'e	guide
are b'anowinaq	guilty
b'antajik	guy
ak'alab'	guys
sak'alib'al	gym
naq'tisam ub'anik	habit
achichib'al	habitat
xk'oji'	had
saqb'ach	hail
wi'aj	hair
nik'aj	half
k'olib'al	hall
q'ab'	hand
uchakuxik	handle
je'l upetik	handsome
uxekeb'axik	hang
elem b'ik	hang out
ok'owem	happen
k'ulmatajinaq	happened
ki'kotemal	happiness
kikotem rech	happy
uq'alajisaxik jun chi junab'	happy birthday
utzalaj uq'axexik alaxib'al chi awech	happy birthday to you
ki'kotemal k'ak' junab'	happy new year
ko	hard
k'ate'	hardly
xaq junelik	hardly ever
k'ax	harm
etzelal	harm
ub'anik k'ax	harm
kub'an k'ax	harmful
junamil	harmony
k'ax	harsh
wachinem	harvest
k'o	has
tzel krilo	hate
k'olik	have
sib'alaj jun utzalaj q'ij chi awech	have a good day
jun utzalaj q'ij chi awech	have a nice day
wa re nimaq'ab'	have breakfast
ki'kotemal	have fun
atijom awa	have you eaten
ruk' ruk'a'xik	having
k'axk'olil	hazard
muqulik sutz'	haze
are'	he
are' k'o	he has
are'	he is
jolom	head
q'oxom jolomaj	headache
kunaxik	heal
kunanem	healing
utzwachil	health
k'o utzwachil	healthy
uta'ik	hear
ta'om	heard
anima	heart
oyowarik	heat
umeq'ik	heat
oyowal	heat
b'ukunik	heat
q'aq'	heat
b'ukuwem	heat
chikaj	heaven
al	heavy
ya'om uq'ij	hectic
raqan	height
ajecheb'anelab'	heir
elaq'	heist
xinchapo	held
q'aq'	hell
Jacha'	Hello
jacha' loq'alaj	hello dear
jacha' utz awach	hello how are you
jacha' utz awach	hello how are you doing
tob'al jolomaj	helmet
tob'anik	help
tob'anem	helpful
xa k'u cha'	hence
rech	her
jupuq chij	herd
waral	here
na'tajsab'al	heritage
mayowem	hesitate
Jacha'	Hey
Jacha'	Hi
jacha' utz awach	hi how are you
utz awach	Hi there
owatalik	hidden
rowaxik	hide
eqelomal	hierarchy
nim raqan	high
ukojik retal	highlight
b'inem	hike
upaqalik	hiking
tze'b'al ub'anik	hilarious
ixkanul	hill
ri	him
uwi' a'	hip
utza'm achaq	hips
uchokik	hire
chokonem	hiring
rech	his
uxe'al	history
ch'ayanik	hit
Mmm	Hmm
q'axeb'al ramaj	hobby
uchapik	hold
reye'xik	hold on
jul	hole
q'ij rech uxlanem	holiday
jul	hollow
achoch	home
chak	homework
b'anal suk'il	honest
b'anal suk'il	honestly
ukab'il	Honey
loq'alaj	Honey
ukab' ajij	Honey
Kab'	Honey
ya'b'al q'ij	honor
t'o'y	hood
tiqchapab'al	hook
xk'anik	hop
ch'ijk'il	hope
eye'nik	hope
ch'ijb'al	hope
q'alb'al k'u'x	hope
eye'b'al	hope
k'o uch'akanik	hopefully
man k'o ta eye'b'al	hopeless
q'e'lik	horizontal
ta'ob'al	horn
xib'ib'al	horrible
itzel sik'	horror
kej	horse
ja kunanib'al	hospital
k'o pa ja kunanib'al	hospitality
ruk'axik	host
ajchoq'e	host
rech	host
wokonel	host
k'ulel	hostile
k'atan	hot
hotel	hotel
ramaj	hour
taq ramaj	hours
ja	house
raqan uq'ab' ri ajupaja	household
pacha'	how
jas uwach chi awij	how about you
utz awach	how are you
jas ab'anom	how are you doing
jas ktajin kub'an we q'ij chi awach	how are you doing today
jas ab'anom kamik	how are you today
jas ab'anom	how do you do
jas ub'anik	how is
janik'pa'	how many
janik'pa'	how much
chi jantaq	how often
janik'pa' ajunab'	how old are you
jas xub'an ri aq'ij	how was your day
jas xub'an ri achaq'ab'il	how was your night
xa k'ut	however
waqwach	hub
achajilom ixoqilom	hubby
laq'apunem	hug
malalajenik	hug
laq'apunik	hug
malalajem	hug
sib'alaj nim	huge
winaq	human
k'o ta umak	humble
raxqinilik	humid
raxal	humidity
jok'al	hundred
k'o unumik	hungry
tzukunem	hunt
keb' raqan	hurricane
aninaqil	hurry
chakowij	hurry up
ub'anik k'ax	hurt
achajilom	husband
ub'anik aninaqil	hustle
alaj ja	hut
ch'ajch'ob'em	hygiene
In	I
In	I am
Utz nub'anom	I am fine
Kinkowinik	I can
Man kinkowin taj	I can't
In kinb'ano	I do
Man weta'm taj	I do not know
Man kinch'ob' taj	I do not understand
Man in taj	I don't
Man weta'm taj	I don't know
Man kinch'ob' taj	I don't understand
Man kinch'ob' taj jas kawaj kab'ij	I don't understand what you mean
Man katinch'ob' taj	I don't understand you
Weta'm taj	I don’t know
Man kinch'ob' taj	I don’t understand
qab'ana che	i guess
Xk'oji'	I had
K'o	I have
Ink'olinaq	I have been
Are kinweye'j	I hope so
Weta'am	I know
Utz kinwilo	I like
Utz katwilo	I like you
Kwaj	I love
Kinloq'oj ri watz	I love my big brother
Kinloq'oj ri wanab' nab'e'al	I love my big sister
Kinloq'oj ri nutat	I love my father
Kinloq'oj ri alaj nuchaq'	I love my little brother
Kinloq'oj ri wanab'	I love my little sister
Kinloq'oj ri nunan	I love my mother
Katin loq'oj	I love you
Sib'alaj katwaj	I love you so much
Xuquje' in katwaj	I love you too
Kwaj kinb'ij	I mean
Katinb'isoj	I miss you
Sib'alaj katinb'isoj	I miss you so much
Kinwilo	I see
Kinchomaj	I think
Kinch'ob'o	I understand
Kwaj	I want
Kwaj katinwilo	I want to see you
Katwaj	I want you
Xinb'e	I was
Kinb'e pa	I will
Pa uchuq'ab'il	I would be
In	I'm
Utz nub'anom	I'm fine
utz nub'anom	I'm good
In k'o waral	I'm here
Kuyu'	I'm sorry
kaxlan tew	ice
t'ajtij	ice cream
no'j	idea
qas utz	ideal
junam	identical
rilik	identify
k'utwinaqil	identity
pay	idiot
jamal uwach	idle
we	if
uya'ik kanoq	ignore
yowab'	ill
man ya'om ta b'e chech rumal q'atb'altzij	illegal
yab'il	illness
Ilocano	Ilocano
wachib'al	image
uchomaxik aq'anoq	imagine
aninaqil	immediate
aninaqil	immediately
sib'alaj nim	immense
ropanik	impact
man k'o ta koch'onik	impatient
uya'ik	implement
rilik	import
rilik apanoq	import
jek'ik	import
jek'onem	import
sib'alaj rajawaxik	important
uya'ik	impose
k'ax ub'anik	impossible
uya'ik uq'ij	impress
nab'anem	impression
sib'alaj je'lik	impressive
ub'anik utz che	improve
ub'anik rutzil	improvement
pa	in
xuquje'	in addition
Rech b'anoj	In fact
chi uwach rech	in front of
chech	in order to
man utz ta ub'ixik	inappropriate
tojb'al	incentive
k'axk'ol	incident
uya'ik	include
chi'l	including
okem	income
k'axk'olil	inconvenience
unimarisaxik	increase
upaqab'axik	increase
uk'iyik	increase
ktajin uya'ik	increased
maj jewi	incredible
xa k'u jewa'	indeed
man k'o ta chi'l	independent
India	India
uya'ik ub'ixik	indicate
mayab' winaq	indigenous
chi jujunal	individual
k'aywokaj	industry
man kq'at taj	inevitable
rech k'iysanik	infant
chomarem	infection
man k'o ta rajilb'alil	infinity
chomarisanem	inflammation
chomarem	inflation
yakanik	influence
uk'amik b'e	influence
k'amol b'e	influence
kyakow rech	influence
q'alajisanem	inform
q'alajisanem	information
ri kaya ruk'	ingredients
echeb'al	inheritance
majib'al	initial
utikitajik	initiative
uriqom k'ax	injured
sokotajem	injury
man k'o ta kub'ano	innocent
k'exonem	innovation
ta'onem	inquiry
pay	insane
chaqi'j chikop	insect
man qas ta je k'olik	insecure
uch'apik	insert
chi upam	inside
eta'manik	insight
uta'ik na	insist
waramil	insomnia
karaj kub'ano	inspiration
woktzijonem	inspire
ujeqeb'axik	install
jun q'ij	instance
aninaqil	instant
chi uwach	instead
chi uwach ri	instead of
taqanem	instructions
chakub'al	instrument
yoq'onem	insult
qas utz	insurance
man k'ota b'anom che	intact
wokowinaq	integrity
k'o reta'mab'al	intellectual
k'o eta'manem	intelligence
k'o reta'mab'al	intelligent
k'o uchomanik che	intend
kraj kub'ano	intended
k'o uchuq'ab'	intense
karaj	intention
uriqik ib'	interact
tzijonem	interaction
kraj	interest
karaj kub'ano	interested
sib'alaj k'o kchokon wi	interesting
uminik ib'	interfere
uxo'l	intermediate
k'olotalik	internal
q'axamaq'	international
k'olom	internship
uq'axexik	interpret
aj q'axel tzij	interpreter
uq'atik	interrupt
uta'ik tzijonem	interview
pa	into
okik	introduce
okib'al	introduction
maj kraj kub'ano	introvert
na'b'anem	intuition
man utz taj	invalid
uwokik aq'anoq	invent
ajilan meb'a'il	inventory
ujalk'atixik	invest
usolik uxe'	investigate
sik'inem	invitation
sik'inik	invite
uwujil tojonik	invoice
uya'ik uwujil q'atoj tojonem	invoice
uya'ik uwujil tojonik	invoice
uwujil loq'oj	invoice
k'olem	involve
k'olem chi upam	involved
usuk'maxik atz'yaq	iron
suk'mal atz'yaq	iron
kaxlan tzij	is
rumal ja'	island
tasom	isolated
uya'ik	issue
ucholajixik	issue
reta'maxik	issue
ujab'uxik	issue
uq'alajisaxik	issue
ucholajil	issue
taq jastaq	issues
le	it
are	it is
xb'e	it was
are'	it's
utz la'	it's ok
utz la'	It's okay
jastaq	item
taq jastaq	items
rech	its
In	I’m
xyal	jacket
pa che'	jail
nab'e ik'	January
k'olib'al	jar
uxe' chi'aj	jaw
achixom	jealous
pay	jerk
k'ayib'al etz'eb'alil	jewelry
chak	job
tijow anim	jogging
utz'ib'axik ib'	join
wokaj	joint
etz'anem tzij	joke
ya'l ub'ixik	journalist
b'yajem	journey
ki'kotemal	joy
uq'atzik tzij	judge
q'atal tzij	judge
uwa'l	juice
uwuq ik'	july
pixk'anem	jump
uwaq ik'	june
mes	junk
chi jutz'it	just
xew wi	just
tz'aqat	just
suk'	just
xew chab'ana'	just do it
q'atoj tzij	justice
usuk'maxik	justify
K'iche'	K'iche'
Kalaallisut	Kalaallisut
kojom	keen
ruk'axik	keep
chab'ana jela'	keep it up
tzuqum	kept
k'olib'al saqli'	kettle
lawe	key
ukojik aqan	kick
ak'al	kid
katajin kb'an etz'anem tzij	kidding
kinaq'	kidney
ak'alab'	kids
kamisanik	kill
kaloq'oxik	kind
b'antajem	kind
ub'antajik	kind
kach'ach'atik	kind
ch'ach'atem	kind
loq'onem	kind
jub'eq'	kinda
ruk' loq'ob'al	kindly
ch'ach'atem	kindness
ajawinel	king
tz'umanem	kiss
b'anb'al wa	kitchen
juch'ch'umil	kite
alaj me's	kitten
ch'ekaj	knee
xinweta'maj	knew
pusb'al	knife
achija'il	knight
reta'maxik	know
reta'maxik	knowledge
eta'matalik	known
Konkani	Konkani
Krio	Krio
ukojik retal	label
etal	label
retwokaj	label
uk'olik ak'al	labor
chak	labour
kraj na	lack
aq'anib'al	ladder
ixoq	lady
uya'ik	laid
cho	lake
karne'l	lamb
ch'oko'y	lame
ya'b'al q'aq'	lamp
ulew	land
uwchulew	land
qajem	land
rilb'al chi ronojel	landscape
ch'ab'al	language
ja'nem	lap
raqan	large
uk'isb'al	last
chi uk'isb'al xa k'u man qas ta rajawaxik	last but not least
ukab' b'i'aj	last name
matam	late
chi uk'isb'al	lately
sib'alaj matam	later
ri uk'isb'al	latest
ri uk'isb'al	latter
tze'nem	laugh
tze'nem	laughing
tze'tzotem	laughter
wa rech paq'ij	launch
tz'il atz'yaq	laundry
taqanik	law
uwasaq	lawn
tob'anel	lawyer
uya'ik	lay
lik'q'u'b'al	layer
lya'nik	layout
q'or	lazy
uk'amik b'e	lead
k'amal b'e	leader
uxaq	leaf
tz'uj	leak
pachalem	lean
xk'anem	leap
reta'maxik	learn
eta'manem	learning
uqajik ja	lease
chaq'ixel	least
tz'u'um	leather
uya'ik kanoq	leave
uya'ik b'e	leave
ya'ik kanoq	leave
relesaxik	leave
ya'ik b'e	leave
uxaq wuj	leaves
xinb'insaj	led
moxq'ab'	left
a'	leg
ya'om kanoq	legacy
qas ya'om b'e chech	legal
k'ulmatajem	legend
qas are'	legit
uxlanem	leisure
uqajik	lend
nim	length
k'i taj	less
eta'manem	lesson
uya'ik kanoq	let
tz'ib'wuj	letter
rax ichaj	lettuce
lik'alik	level
upek'ik	leverage
rajawaxik kb'anik	liability
k'olwuj	library
req'ik	lick
ub'anik tzij	lie
ub'anik tzij	lies
k'aslemal	life
paqab'saxik	lift
paqalib'al	lift
wa'lijisanem	lift
paqab'sanem	lift
rajililal	lift
uwa'lijisaxik	lift
uchupik	light
utzijik	light
q'alaj	light
wachinem	light
kaxlan q'aq'	light
xkoyopa'	lightning
pacha'	like
wene	likely
xa k'u jewa'	likewise
juch'	line
Lingala	Lingala
t'iqb'al	link
koj	lion
ja' uwach	liquid
cholajil	list
uta'ik	listen
ta'onem	listening
pacha' ya'om ub'ixik	literally
tz'ib'	literature
mes	litter
nitz'	little
k'olik	live
kamik	live
k'aslem	live
k'amik'	live
k'aslik	live
K'olem	live
pospo'y	liver
taq k'aslemal	lives
k'olem	living
k'olib'al	living room
ixpa'ch	lizard
uya'ik	load
muchunem	loaf
qajanem	loan
ajwaralik	local
k'olib'al	location
utz'apixik	lock
utasik	lockdown
kuta'm	log
jajaja	lol
tukelal	lonely
raqan	long
sib'alaj naj chik wilom awach	long time no see
petik	look
rilik	look
petib'al	look
ilonem	look
junamatajik	look
junamatajem	look
bucle	loop
tzoqopim	loose
tukelam	loose
tukelanik	loose
ukorob'axik	loose
tzoqopinik	loose
koronik	loose
tat	lord
utzaqik	lose
tzaqem	loss
sachinaq	lost
jub'a'	lot
k'o uchuq'ab'	loud
k'olib'al	lounge
utz kinwilo	love
loq'onik	love
loq'ob'al	love
ajawanem	love
ajawanik	love
utz rilik	love
ktinloq'oj	love you
utz	lovely
maj uchuq'ab'	low
uqajik	lower
suk'	loyal
suk'il	loyalty
ch'akanem	luck
ch'akanem	lucky
Luganda	Luganda
k'olib'al jastaq	luggage
eqa'n	lump
wa rech paq'ij	lunch
pospo'y	lungs
k'iyarempatan	luxury
ktajin kub'an tzij	lying
chakub'al	machine
royowal	mad
nan	madam
b'anom	made
wachtz'ib'wuj	magazine
qas je'lik	magnificent
taqo'n	maid
qas nab'e	main
uk'olik	maintain
ujosq'ixik	maintenance
Maithili	Maithili
rajawaxik	major
ajsaqwachom	major
k'o uch'a'ik	major
nim	major
qas kajwatajik	major
uk'iyal	majority
ub'anik	make
uya'ik uk'axel	make up
achi	male
uk'u'x k'ayib'al	mall
achi	man
uk'amik b'e	manage
achochib'al	management
kemchajinel	manager
qas rajawaxik wi	mandatory
ub'ixik	manifest
ukojik	manipulate
b'antajik	manner
tijon wuj	manual
k'i	many
ktz'aqatisaj ta b'a' k'i junab' na	many many happy returns of the day
b'inem	march
uchi'	margin
k'ayib'al	market
meb'a'il	marriage
k'ulanik	married
k'oj	mask
ch'ab'al	mass
k'o uchuq'ab'	massive
ajchoq'e	master
ujunamaxik	match
tzijb'al q'aq'	match
achi'l	mate
chakub'al	material
taq ajilanb'al	math
uchomaxik	matter
ucholajixik	matter
uk'amik loq	matter
jastaq	matter
ucholajil	matter
nimarem	maturity
wene	may
uxlanem	may
mayo	may
wokinem	may
la	may
pine'	maybe
kin-	me
in xuquje'	me too
rikil	meal
q'alajisanem	mean
retal	mean
itzel	mean
etalil	mean
uq'alajisaxik	mean
pa nik'aj	mean
nik'aj	mean
kel kub'ij	meaning
unik'ajal	means
xwaj xinb'ij	meant
are tzij	meanwhile
retaxik	measure
etb'alil	measures
ti'ij	meat
ajkun	medical
kunab'al	medicine
uchomaxik	meditation
nik'aj	medium
uch'ob'ik uwach	meet
riqoj ib'	meeting
Meiteilon	Meiteilon
ja'rik	melt
taq k'oxomab'al	memories
k'oxomab'al	memory
pa chomanik	mental
uya'ik ub'ixik	mention
ya'om ub'ixik	mentioned
ajno'jinel	mentor
ajk'ay	merchant
tow toq'ob'	mercy
alaxb'al	merry christmas
nimalaj k'ax	mess
oqxa'n	message
man cholajim taj	messy
ch'ich'	metal
k'amb'alcholajil	method
e ch'o	mice
nik'aj	middle
nik'aj aq'ab'	midnight
wene	might
ch'uch'uj	mild
etal	milestone
chajinel	military
uwa'l tu'	milk
wuqlk'ala'	million
ilawachinem	mind
k'oxomanem	mind
uk'ami loq	mind
ilawachinik	mind
chomanem	mind
k'oxomanik	mind
chomanik	mind
k'oxomab'al	mindset
wech	mine
etab'al	mine
ech	mine
kajunamatajik	mingle
maja ujunab'	minor
kajb'al	minute
taq kajb'al	minutes
mayib'al	miracle
ilb'al ib'	mirror
jaljoj uwach	miscellaneous
k'ax uch'ab'exik	mischievous
meb'a'	miserable
meb'a'	misery
b'isonik	miss
katinmayo	miss you
sachinaq	missing
misión	mission
sutz'	mist
sachem	mistake
Mizo	Mizo
achib'il ch'aweb'al	mobile
ub'ixik tzij	mock
k'utunem	model
b'anom q'atenem che	moderate
q'atenem	moderate
uq'atik	moderate
k'ak'arisam	modern
meb'a'	modest
raxqinilik	moist
raxqinilik	moisture
pus	mold
b'anik	mold
b'anb'al	mold
raxqi'n	mold
rikil	mole
nan	mom
q'ij ri'	moment
nab'e q'ij	monday
pwaq	money
k'utwachib'al	monitor
k'oy	monkey
ik'	month
tze'b'alil	mood
man k'o ta karaj	moody
ik'	moon
Utzik'u'x	moral
nik'aj chik	more
xuquje'	moreover
aq'ab'il	morning
uqajik pwaq chi uwach ri ja	mortgage
ri uk'iyal	most
pa uk'iyal	mostly
nan	mother
silob'em	motion
paqchib'al rech	motivation
juyub'	mountain
ch'o	mouse
chi'aj	mouth
silab'em	move
silob'em	movement
k'utwachinem	movie
nan	mrs
k'i	much
xaq'o'l	mud
alaj xa'r	mug
tyo'jilal	muscle
k'olib'al ojer jastaq	museum
ikox	mushroom
q'ojom	music
rajawaxik kb'anik	must
rajawaxik	must
kb'anik	must
qas are wi	must
mem	mute
junamil	mutual
un	my
Nuloq'aj	My dear
wachi'l	my friend
Ri nujililb'al nojinaq chech chikop	My hovercraft is full of eels
nuloq'ob'al	my love
ri nub'i' are'	my name is
k'o ta kub'ano	my pleasure
in wi	myself
kajamb'al	mysterious
kajamb'al	mystery
xk'ulmatajem	myth
ixk'aq	nail
aj no'j	naive
b'i'aj	name
uya'ik ub'ixik apanoq	narrative
nitz' uwach	narrow
tzel una'ik	nasty
tinamitalil	national
tinamitalil	nationality
qas alaxinaq wi	native
natural	natural
qanan ulew	nature
xa'oj	nausea
naqaj	near
naqaj	nearby
jutz'it chik	nearly
sib'alaj utz	neat
rajawaxik	necessary
qulaj	neck
chachal	necklace
kraj na	need
rajawaxik	need
ch'a'ik	need
uch'a'ik	need
maj	negative
uya'ik kanoq	neglect
uqasaxik rajilal	negotiate
k'ulja	neighbor
k'ulja	neighborhood
man chi'l ta	neither
ch'utik'ajol	nephew
nerd	nerd
kuxe'j rib'	nervous
soktz'ikin	nest
k'olik	net
kemk'at	network
man k'o ta ub'e'al	neutral
junelik	never
man kaya ta wi kanoq	never give up
sachom kanoq	never mind
sacha kan chla'	nevermind
xa k'u cha'	nevertheless
k'ak'	new
taq xajtajem	news
jun chik	next
chi utzalaj rech	next to
je'lik	nice
ki'kotemal reta'maxik awach	nice to meet you
ch'utik'ajol	niece
chaq'ab'	night
itzel wachik'	nightmare
b'elejeb'	nine
b'elejlajuj	nineteen
jumuch' lajuj	ninety
Ja'i'	No
man k'o ta k'eyowal	no problem
man jumul ta wi	no way
maj	nobody
wululem	noise
kawululik	noisy
maj	none
unik'ajal q'ij	noon
ja'i'	nope
man chi'l ta	nor
retal	normal
releb'al kaqiq'	north
tza'maj	nose
q'ututem	nostalgic
ja'i'	not
maj wi	not at all
man qas ta are' che k'ax	not bad
Chanim ja'i'	Not now
maja na	not yet
ub'ixikil	note
tz'ib'am	noted
maj	nothing
uya'ik ub'ixik	notice
xinwilo	noticed
b'i'aj	noun
b'i'aj	nouns
nob'el	novel
ujulaj ik'	november
chanim	now
kamik q'ij	nowadays
k'axk'ol	nuisance
man k'o ta kub'ano	null
q'oxowem	numb
ajilab'al	number
chajinel yawab'	nurse
nuez	nut
kok'amani'y	nutmeg
tzuqunem	nutrition
suk'matajem	oath
chomarem	obesity
unimaxik	obey
jastaq	object
ajawatajem	objective
rajawaxik kb'anik	obligation
qequ'm	obscure
ilonem	observation
rilik	observe
mayowem	obsessed
mayowem	obsession
k'isnaq uq'ijol	obsolete
q'ateb'al	obstacle
uriqik	obtain
xinriqo	obtained
je wi	obvious
qas jewi	obviously
chub'anik	occasionally
uchak	occupation
man tolon ta uwach	occupied
k'ulmatajik	occur
k'ulmatajinaq	occurred
kk'ulmatajik	occurs
saqpolo	ocean
ulaj ik'	october
jun wi	odd
junwi	odds
rech	of
jewi	of course
chupum	off
k'ax tzij	offensive
utzujuxik	offer
qasam rajilal	offer
uqasaxik rajilal	offer
tzujunem	offer
ja chakub'al	office
kojom	official
amaq'el	often
Oh	Oh
ah che tzij	oh really
qepowja'	oil
utz	ok
utza loq'alaj	ok dear
utz la' loq'olaj	ok honey
utz la' nuloq'ob'al	ok my love
utz	okay
utz la' ne'	okay baby
utz la' loq'alaj	okay dear
utz la' loq'alaj	okay honey
utza' nuloq'ob'al	okay my love
ri'j	old
pa	on
jumul	once
jun	one
jun ch'ab'al man kub'ana taj	one language is never enough
sipoyix	onion
pa nimk'atz	online
xew	only
jaqom	open
uchakuxik	operation
utzijolil rij	opinion
jalajoj taq uya'ik	opportunities
ya'tajem	opportunity
jalan wi	opposite
kki'kotik	optimistic
jalajoj ucha'ik	option
jalajoj ucha'ik	optional
on	or
tz'ajb'al q'anq'oj	orange
alanxax	orange
kaqkoj	orange
ucholajixik	order
ta'ik	order
cholajinik	order
ta'onem	order
taqanik	order
taqanem	order
cholajinem	order
amaq'el	ordinary
wokaj	organization
no'jinem	orientation
uxe'al	origin
qas are'	original
Oromo	Oromo
minor	orphan
jun chik	other
jun chi ub'antajik	otherwise
rajawaxik	ought
qa	our
Ri qachak: Uya'ik b'e chi kech konojel, pa ronojel tinamit, kaketa'maj ri uwachulew xuquje' ri tzijonem pa ronojel taq ri ch'ab'al.	Our mission: to enable everyone, everywhere to understand the world and express themselves across languages.
Ri qachak: unuk'maxik ri q'alajisanem rech ronojel uwachulew xuquje' are che utz kab'an okem chi upam xuquje' qas kchokonik.	Our mission: to organize the world's information and make it universally accessible and useful.
elem b'ik	out
uwachinem	outcome
jastaq	outfit
elem b'ik	outgoing
esab'al kaxlan q'aq'	outlet
chi rij	outline
chi rij	outside
qas kch'akanik	outstanding
miq'sab'al	oven
chi rij	over
chi waral	over there
pa uwi' ronojel	overall
uxalq'atixik	overcome
k'i uchomaxik	overthinking
b'isonem	overwhelmed
kosib'al	overwhelming
rajawaxik	owe
tukur	owl
k'olik	own
ajchoq'e	own
rech	own
ajchoq'e	owner
juk'ulaj wakax	ox
ok'owib'al	pace
tanaj	pack
tanaj	package
xintojo	paid
q'oxom	pain
tz'ajanik	paint
tz'ajb'al	painting
uk'ulaj	pair
saqtub'	pale
upa q'ab'aj	palm
q'anarisab'al	pan
nimalaj yab'il	pandemic
saka'w	pants
uxaq wuj	paper
para'is	paradise
junamil	parallel
oqxa'n	parcel
kuyu'	pardon
tat nan	parents
uxlanib'al	park
lo'r	parrot
kawachkulanto	parsley
utz'aqatil	part
k'olem	participate
tukelal	particular
k'ulajil	partner
nimaq'ij	party
uq'axexik	pass
b'e	passage
xinok'owik	passed
qas kab'anik	passion
qas karaj kub'ano	passionate
relik rajilal b'ik	passive
retokib'al	password
q'axnaq kanoq	past
k'ojob'al	patch
b'e	path
qas q'an che	pathetic
k'o uch'ijb'al	patience
k'o uch'ijb'al	patient
koch'kil	patient
ajchaq'e chak	pattern
uq'atab'axik	pause
b'e b'anom ruk' ixim ab'aj	pavement
utojik	pay
tojonik	payment
jamaril	peace
k'o reyeb'al	peaceful
q'antura's	peach
uwi'	peak
raxtzu	pear
alb'erxex	peas
b'antajik	peculiar
chulunik	pee
chulunem	pee
uch'olik	peel
k'ulaj	peer
junam	peers
tz'ib'ab'al	pen
che' tz'ib'ab'al	pencil
yamalik	pending
e winaq	people
pimienta	pepper
uya'ik ub'ixik	perceive
chomanem	perception
suk'	perfect
uchak upatan	perform
nim uchak upatan	performance
wene	perhaps
uq'ijol	period
junelik	permanent
uya'ik b'e	permission
uya'ik b'e	permit
koch'onem	perseverance
k'o ukoch'onik	persistent
winaq	person
ajchakib'	personal
uwinaqil	personality
ub'antajik	perspective
uk'amik b'e	persuade
maj uk'ix	pervert
maskot	pet
cholajil	phase
k'exonem	phenomenon
chomanem	philosophy
ch'aweb'al	phone
wachib'al	photo
nitz' chomanik	phrase
petib'al	physical
usik'ik	pick
usik'ik	pick up
wachib'al	picture
utz'aqat	piece
utz'aqat	pieces
aq	pig
palomax	pigeon
unutik	pile
ch'akataj	pillow
b'insal ch'ich'	pilot
b'aq	pin
ch'op	pineapple
kaqkoj	pink
jul	pit
uqajb'al	pitch
k'eyowal	pity
utinamitalil	place
k'olib'al	place
achochib'al	place
tinamit	place
taq k'olib'al	places
plaga	plague
li'anik	plain
q'ayes	plan
xik'ich'ich'	plane
q'ayes	plant
taq q'ayes	plants
wab'al	plate
t'uyulb'al	platform
etz'anem	play
chapanik	play
retz'ab'exik	play
etz'anik	play
uchakuxik	play
chakuxik	play
chak	play
etz'anem	playing
sib'alaj je'lik	pleasant
usachik makaj	please
sacha numak	please
chab'ana jun toq'ob'	please
jun toq'ob'anik	please
kuyu'	please
kaqajik	please
k'uyunik	please
utz rilom	pleased
b'anoj	pleasure
uchi'xik	pledge
maj uk'isik	plenty
nuk'maxik	plot
ut'iqik	plug
k'uxk'ab'el	plum
jeqol joron	plumber
k'iyal	plural
podcast	podcast
nab'alil	poem
nab'alil	poetry
nak'	point
itzel kunab'al	poison
ajchajil tinamit	police
taqanik	policy
kch'ach'atik	polite
kuya yab'il	pollution
muxanb'al	pond
muxanib'al	pool
kis	poop
meb'a'	poor
paq'inik	pop
k'o uch'a'ik	popular
winaqib'	population
aq	pork
mox	porridge
okib'al	port
k'olib'al	position
qas are'	positive
k'o	possess
k'olib'al	possession
ajch'uqelal	possessive
kb'anik	possible
taqoqxa'nib'al pa kematz'ib'	post
ujab'uxik	post
uya'ik kan pa jun q'ij chik	postpone
saqwach	potato
uchuq'ab'il	potential
libra	pound
meb'a'	poverty
uchuq'ab'il	power
k'o uchuq'ab'	powerful
qas kb'anik	practical
naq'tisam ub'anik	practice
ub'anik	practice
reta'maxik	practice
b'anoj	practice
uya'ik q'ij	praise
etz'anem tzij	prank
ub'ixik ch'ab'al	pray
je'lik	precious
qas are'	precise
qas are wi	precisely
uya'ik ub'ixik apanoq	predict
are kraj	prefer
ajawatajem	preference
yowab' ixoq	pregnant
mayowem	prejudice
taq k'olib'al	premises
are qas nab'e	premium
unuk'maxik	preparation
ub'anik	prepare
k'o chik	prepared
nab'e k'olik	preposition
k'olem	presence
k'olem	present
tyoxinem	present
sipanem	present
k'utunsanem	presentation
uk'olik kanoq	preserve
k'amal b'e rech amaq'	president
wuj q'alajisab'al	press
pitz'onem	press
upitz'ik	press
uchuq'ab'il	pressure
ujaluxik	pretend
je'lik	pretty
utz upetik	pretty
je'lalaj	pretty
utz	pretty
k'iyarem	pretty
uq'atik uwach	prevent
mojo'qa che	previous
chapanem	prey
rajilal	price
nimal	pride
pare	priest
nab'e	primary
sib'alaj je'lik	prime
ixq'alel	princess
k'amal b'e	principal
jun kanoq	prior
rilik ub'anik	priority
che'	prison
echeb'alil	privacy
rech tukelal	private
eqele'n	privilege
ch'akanem	prize
wene	probably
k'eyowal	problem
b'anoj	procedure
ub'anik	proceed
ucholajixik	process
ukojik wuj pa q'atb'altzij	process
q'axnem	process
uq'axexik	process
cholajil	process
ub'anik	produce
k'ayij	product
ub'anik	production
riqtijonem	profession
ajsaqwachom	professional
cholk'aslemal	profile
ch'akoj	profit
nim qajinaq	profound
q'axnik	progress
yakatajem	progress
katajik	progress
uwa'lijisaxik uwach	progress
q'axnem	progress
cholchak	project
chi'xik	promise
chi'nem	promise
uya'ik q'alb'al k'u'xaj	promise
uchi'xik	promise
uya'ik	promote
paqalinem	promotion
aninaq	prompt
jupulem	prone
uk'exwach b'i'aj	pronouns
jas ub'ixik	pronunciation
k'amb'ejanem	proof
b'anom rech chech	proper
qas utz ub'anik	properly
ub'antajik	properties
ub'antajik	property
kaya ub'ixik	proposal
jalajoj ub'ixik	prospect
tewechib'al	prosperity
k'o umeb'a'il	prosperous
uchajixik	protect
nimal	proud
retaxik	prove
uya'ik	provide
xinya'o	provided
alaj tinamit	province
patanib'al	provision
k'ajolal	puberty
kech uk'iyal	public
ujek'ik	pull
tz'etz'	pumpkin
atam ke'opanik	punctual
tijoxel	pupil
loq'oj	purchase
qas tzij	pure
raxpopoj	purple
ajawatajem	purpose
k'olib'al jastaq	purse
uterne'xik	pursue
uterne'xik	pursuit
upaqchixik	push
uya'ik	put
k'o uwujil	qualification
uq'alajilal	quality
uk'iyal	quantity
tastajem	quarantine
ch'o'jinem	quarrel
ch'ojinik	quarrel
ta'onem	quarrel
ukaj utz'aqat	quarter
Quechua	Quechua
rajawal ixoq	queen
jun wi	queer
esab'al ab'aj	query
k'otow chi'aj	question
cholajinik	queue
k'isb'alil	queue
ucholajixik ib'	queue
cholaj	queue
je'	queue
aninaq	quick
aninaqil	quickly
matzalik	quiet
q'u'aj	quilt
relesaxik	quit
relesaxik	quite
chi ronojel	quite
qas je wi	quite
sib'alaj k'i	quite
k'amb'ejanem	quiz
sik'inem	quotation
sik'ixik	quote
sik'inem	quote
taq sik'inem	quotes
imul	rabbit
upetib'al	race
k'anal	rage
jab'	rain
nimarisanik	raise
nimarisanem	raise
paqab'anem	raise
xib'inik	raise
upaqab'axik	raise
kk'iysaxik	raised
xinanimajik	ran
xaq k'ate'	random
eqelomal	range
aninaq	rapid
aninaqil	rapidly
jun wi	rare
jun wi	rarely
puluw xkanul	rash
b'ayi's	rat
rajilal	rate
are kjawataj	rather
uqajb'al	ratio
suk'	rational
rax	raw
jastaq	re
uch'akik	reach
unimal	reached
uk'ulaxik uwach	reaction
usik'ixik uwach	read
usik'ixik uwach	reading
utz chik	ready
qas tzij	real
qas ub'e'el	reality
kya kwent che	realize
ch'ob'om	realized
qas tzij	really
chi rij	rear
ub'antajik	reason
utz uchomaxik	reasonable
una'tajisaxik	recall
uwujil tojonik	receipt
uk'amik	receive
xink'amo	received
maja naj	recent
maja naj	recently
uk'amik	reception
cholajil saqil	recipe
man kk'oxoman taj	reckless
uch'ob'ik uwach	recognition
uch'ob'ik uwach	recognize
uq'xa'nitalik	recommend
uqxa'nitalik	recommended
okem	record
uk'olik	record
k'olonem	record
k'olinik	record
utz'ib'axik	record
okik	record
uriqik chi jumul	recover
uriqik chi jumul	recovery
nim kajxukut	rectangle
kaq	red
uchupik	redeem
kolotajem	redemption
unitz'arisaxik	reduce
kamulim	redundant
utaqik b'ik	refer
usaqil tzij	reference
kutunem	reflect
uwachinem	reflection
uq'atik ib'	refrain
t'ajajarisab'al	refrigerator
utzalijisaxik	refund
kamul ukojik	refuse
kamul ukojik	refused
uchomaxik rij	regard
are tzij ri	regarding
man are ta kub'ij che	regardless
rutzil wachaj	regards
rulewal tinamit	region
utz'ib'axik	register
umayik	regret
ub'anik utz che	regular
jewi	regularly
retzelaxik	reject
ujunamaxik	relate
kajunamatajik	related
ub'antajik	relationship
kajunamatajik	relative
k'amarem	relative
alaxik	relative
junamatajem	relative
achalaxik	relatives
uxlanem	relax
jab'unem	release
ujab'uxik	release
uya'ik b'e	release
tzoqopixik	release
tzoqopinem	release
ya'om b'e chech	released
k'o uch'a'ik	relevant
q'alb'al k'u'xaj	reliable
jororem	relief
uqasaxik	relieve
uxlanaq	relieved
kojb'al	religion
kojb'al	religious
man knimaj taj	reluctant
q'alb'al k'u'x	rely
k'olem	remain
uwi'	remaining
kq'alajinik	remarkable
ukunab'alil	remedy
una'tajisaxik	remember
una'tajisaxik	remind
una'tajisaxik	reminder
najtajisam	remote
relesaxik	remove
uya'ik kanoq	render
qajik	rent
ujeqik	repair
ukamulixik	repeat
ujalik	replace
uk'ulaxik uwach	reply
utzalijisaxik uwach	reply
q'alajisanem	report
uq'alajisaxik	report
uya'ik ub'ixik	report
uk'utunsaxik	represent
uwinaqilal	reputation
ta'om	request
utz'onik	request
uriqom k'ax	request
k'ayinik	request
k'ayij	request
kajawatajik	require
xintz'ono	required
kolonem	rescue
usolik uxe'	research
k'utunsanem	resemble
k'ax pa anima	resentment
ukolik apanoq	reservation
uk'olik kanoq	reserve
aj waralik	resident
uya'ik kan jun chak	resign
ajch'akanel	resilient
uch'ijik	resist
ch'ijkil	resistance
usolik uwach	resolution
usolik uwach	resolve
pataninem	resort
pataninem	resources
k'ixb'anik	respect
k'ixb'alil	respect
ita'ik toq'ob'	respect
unimaxik	respect
uk'ulaxik uwach	respond
uk'ulaxik uwach	response
q'alb'al k'u'x	responsibility
are ka'ilowik	responsible
uxlanik	rest
jamaril uxlanem	rest in peace
tijb'al wa	restaurant
ub'anik utz che	restore
uq'atexik	restrict
wachinem	result
taq uwachinem	results
uch'utinirisaxik	resume
k'ayij man chi kech uk'iyal taj	retail
uq'atik	retain
uq'atexik	retention
man kchakun ta chik	retired
elenaq chik	retreat
uriqik chi jumul	retrieve
tzalijem	return
uq'alajisaxik	reveal
q'alajisam	revealed
utzalixik uk'axel	revenge
q'atoj tojonik	revenue
chi rij	reverse
nik'oxik	review
unik'oxik	review
q'atuxik	review
uq'atuxik	review
rilik chi jumul	review
uq'atuxik	revise
uq'atuxik	revision
k'exonem	revolution
uwachinem ch'akoj	reward
junab'inb'al	rhythm
k'alk'a'x	rib
aros	rice
q'inom	rich
relesaxik	rid
b'insanik	ride
k'amanem	ride
uk'amik b'e	ride
k'amanik	ride
paqi'k	ride
ub'insaxik ch'ich'	ride
utz ta rilik	ridiculous
wikiq'ab'	right
suk'il	right
utz	right
suk'	right
chanim	right now
ko	rigid
mulq'ab'	ring
umub'axik	rinse
ub'anik k'ax	riot
jisonem	rip
ujisik	rip
ko	ripe
paqalik	rise
nimarisanem	rise
paqalem	rise
nimarisanik	rise
k'axk'olil	risk
k'eyowal	risk
ub'anik wi	risk
k'ulel	rival
nima'	river
b'e	road
uk'ilixik	roast
kowilaj	robust
nim ab'aj	rock
b'ara	rod
wuj	role
usutixik	roll
uwi ja	roof
achoch	room
ra'	root
kolob'	rope
q'ayinaq	rotten
q'irinik	rough
ruk' ch'a'ojimarem	roughly
ketekik	round
b'e	route
amaq'el	routine
cholaj	row
b'och'onem	rub
ul	rubber
ik'	rubbish
man k'o ta uk'ixb'al	rude
upopil upaja	rug
b'enik pa k'ax	ruin
taq taqanik	rule
ajpop	ruler
taqanem	rules
tijoj anim	run
uchakuxik	running
nitz' tinamit	rural
utijik anim	rush
relesaxik pa chak	rush
aninaqil	rush
ralesaxik	rush
koxtar	sack
awas	sacred
q'ijilanik	sacrifice
qas utz	safe
utzalaj xik'inem	safe flight
chajinem	safety
salb'i'a	sage
b'im	said
nik'onem	sail
nik'onem	sailing
pa ub'i' rech	sake
rajilal chi ik'	salary
k'ayij	sale
kar	salmon
xik'anik	salt
kjunamatajik	same
Xuquje' waral	Same here
k'utunsanem	sample
sanyab'	sand
Sanskrit	Sanskrit
k'a'n	sarcastic
tzok'b'al	sassy
xint'uyi'k	sat
utz rilik	satisfaction
utz krilo	satisfied
utz krilo	satisfy
utz chik	satisfying
uwaq q'ij	Saturday
b'olob'ik ti'ij	sausage
rech juyub'	savage
k'olonem	save
xinwilo	saw
ub'ixik	say
upajb'alil	scale
elaq'	scam
yuk	scar
karaj na	scarce
uxib'im rib'	scared
tasb'al qulaj	scarf
uxi'm rib'	scary
jab'um	scattered
perwachnem	scene
Paisaj	scenery
k'ok'al	scent
cholajik	schedule
ramajil	schedule
ucholajil	schedule
ramaj	schedule
unuk'maxik	schedule
tijob'al	school
saqil eta'manik	science
ch'ob'nel	scientist
q'inom eta'manel	scientists
qupib'al	scissors
yajanem	scold
ropanem	scope
ch'ak'anem	score
kutz	scrap
k'aqatem	scratch
raqoj chi'aj	scream
q'axwachib'al	screen
t'ajib'al	screw
jilanjuch'	script
polow	sea
k'ayinem	seal
tzukunik	search
uq'ijol	season
t'uyulb'al	seat
alaj kajb'al	second
owatalik	secret
k'olib'al	section
qas utz	secure
chajinem	security
rilik	see
katinwilo	see you
kqil qawach aq'anoq	see you later
man naj taj kinwil chi awach	see you soon
kaqil qib' chwe'q	see you tomorrow
ija'	seed
utzukuxik	seek
kajunamatajik	seem
kajunamatajik	seems
ilom	seen
uchapik	seize
umajik	seizure
jun wi	seldom
ucha'ik	select
are' wi	self
tukelal kunanem	self healing
xu'y	selfish
uk'ayixik	sell
utaqik	send
chataqa loq jun awachib'al chi wech	send me your picture
nim	senior
nab'alil	sense
ch'in ranima	sensible
k'ax kuna'o	sensitive
xintaqo	sent
tz'aqat chomanik	sentence
tz'aqat chomanik	sentences
upa'ixik	separate
Sepedi	Sepedi
ub'elej ik'	september
ucholajil	sequence
kemq'axeb'al	series
man katze'n taj	serious
che tzij	seriously
patanixik	serve
pataninem	service
chomal	session
ya'ik	set
etz'anem	set
chapanik	set
ya'onem	set
etz'anik	set
ch'apanem	set
ujeqeb'axik	set up
suk'manem	setting
ya'om	settle
wuqub'	seven
wuqlajuj	seventeen
oxk'al lajuj	seventy
k'i	several
nim ucholaj	severe
t'isonem	sew
sh	sh
mu'j	shade
mu'j	shadow
utotaxik	shake
rajawaxik kb'anik	shall
nim ta qajinaq	shallow
q'oxom k'u'xaj	shame
ub'antajik	shape
ukomonexik	share
k'o uware	sharp
are'	she
are' k'o	she has
are'	she is
q'u'aj	shed
chi'j	sheep
uxaq	sheet
k'olib'al jastaq	shelf
parapox	shell
k'olib'al	shelter
to'b'al ib'	shield
k'exonem	shift
repq'unem	shine
nim jukub'	ship
utaqik	shipping
kami'x	shirt
xajab'	shoes
k'aqanem	shoot
k'ayib'al	shop
taq loq'oj	shopping
uchi'	shore
ko'lik	short
man qas ta k'olik	shortage
k'aqik	shot
k'aqanem	shot
rajawaxik kb'anik	should
teleb'	shoulder
raqoj chi'aj	shout
q'alajisanem	show
ilonem	show
k'utunem	show
ilonik	show
uk'utik	show
q'alajisanik	show
chakutu' chi nuwach	show me
atinib'al	shower
cho'm	shrimp
nitz'arem	shrink
tz'apilik	shut
man kb'an ta ch'awem	shut up
kuxe'j rib'	shy
achalal	sibling
achalaxik	siblings
yowab'	sick
tzal	side
b'isonem	sigh
rilik	sight
wa'katinel	sightseeing
etal	sign
juch'b'i'aj	signature
k'o uchak upatan	significant
matzatzem	silence
matzatzem	silent
xela	silk
pay	silly
saqapwaq	silver
kjunamatajik	similar
pay	simp
retal	simple
amaq'el	simultaneously
k'a pa	since
qas tzij k'olik	sincere
qas tzij wi	sincerely
b'ixonem	sing
ajb'ixanel	singer
k'ulan taj	single
mub'anem	sink
umub'axik	sink
ukojik tzij chi rij	sink
josq'inik	sink
ch'ajol laq	sink
Tat	Sir
anab'	sister
ixnam	sister in law
t'uyulem	sit
wokk'olib'al	site
b'antajik	situation
waqib'	six
waqlajuj	sixteen
oxk'al	sixty
unimal	size
kowinem	skill
kkowin chech ub'anik	skills
tz'u'mal	skin
b'aq	skinny
uq'axexik	skip
kut uq	skirt
kaj	sky
kb'an k'ax che	slave
warik	sleep
warnaq	sleeping
warem	sleepy
uq'ab'	sleeve
jub'a'	slice
upa'ixik	slice
jilil	slide
jutz'it	slightly
b'aq	slim
jililem	slip
xulanik	slope
k'olib'al	slot
no'jimal	slow
nojimal	slowly
nitz'	small
utz chik	smart
usiqik	smell
tze'	smile
tze'nik	smile
tze'b'al	smile
sib'	smoke
ch'uch'uj	smooth
q'ajb'al	snack
t'ot'	snail
kumatz	snake
upaq'lixik uwi q'ab'aj	snap
saq tew	snow
xa k'u cha'	so
sib'alaj utz	so cute
k'a ch'anim	so far
kamul umub'axik	soak
q'eq'	soap
k'o reta'mab'al	sober
retz'ab'exik potz'	soccer
kech winaq	social
komon	society
tasb'al aqanaj	socks
ch'uch'uj	soft
software	software
uwachulew	soil
k'ayim chik	sold
k'ayim	sold out
chajinel	soldier
utukel	sole
ko	solid
usolik uwach	solution
usolik uwach	solve
nik'aj chik rech	some
jachinaq	somebody
man jewa' ta wi	somehow
jun chik	someone
jun jastaq	something
jujun mul	sometimes
b'ix	song
chanim	soon
sib'alaj paqalik	sophisticated
Sorani	Sorani
ch'a'k	sore
sib'alaj k'ax	sore
k'ax una'ik	sore
q'oxom qulaj	sore throat
k'ajsab'al wachaj	sorrow
Kuyu'	Sorry
ucholajixik	sort
xintzukuj	sought
anima	soul
junamil anima	soulmate
tanib'al	sound
uwa'l ichaj	soup
k'a	sour
uxe'al	source
uqajb'al kaqiq'	south
k'olib'al	space
spam	spam
ruk'a'am	span
Español	Spanish
uya'ik	spare
k'o uwi'	spare
ujalwach	spare
tzijonem	speak
nim upatan	special
b'antajik	species
qas rajawaxik kb'anik	specific
sib'alaj je'lik	spectacular
tzijonem	speech
man k'o ta tzij	speechless
u'aninaqil	speed
ub'ixik chi jujun tz'ib'	spell
uchupik	spend
chupum chik	spent
poqon	spicy
k'ixal	spike
usutixik	spin
spinak	spinach
uxlab'al	spirit
chub'unem	spit
maj jewi	splendid
pa'ib'al	split
upa'ixik	split
ujab'uxik	split
umaq'el ktoq'ob'sax uwach	spoil
qas kaya che ri karaj	spoiled
tob'anel	spontaneous
lajpak'	spoon
k'olib'al	spot
ixoqilom	spouse
unimal	spread
tuxq'ijol	spring
kajxukut	square
uyitz'ik	squeeze
Kalamar	squid
kuk	squirrel
b'e	st
ukojik kuchi'l	stab
utz ub'anom	stable
ch'ajo'nib'al	stack
winaqil	staff
ch'akateb'	stage
soq'onem	stain
taq q'a'am b'e	stairs
stak	stake
ub'anik k'ax	stalk
jachijib'al	stall
retal	stamp
k'olem	stand
tak'alem	stand
k'olib'al	stand
tak'ab'axik	stand
retal	standard
ch'umil	star
umajik	start
xinmajij	started
k'o unumik	starving
b'antajik	state
b'antajem	state
jas ub'anik	state
uya'ik uq'alajisaxik	state
ub'anik	state
rulewal tinamit	state
uq'alajisaxik	statement
k'olib'al	station
tz'aqom wachb'al	statue
ub'antajik	status
k'olem	stay
k'olik	stay
ch'ijonik	stay
ch'ijonem	stay
k'olem qas utz	stay safe
ko k'olik	steady
b'olom ti'ij	steak
elaq'	steal
usib'	steam
koch'ich'	steel
jech'elik	steep
ra'	stem
ok'owib'al	step
che'	stick
ko	stiff
pine'	still
kab'an na	still
matzalem	still
xa k'u cha'	still
b'anik	still
k'ix	sting
xu'y	stingy
usolik uwach	stir
b'anowem	stock
elaq'am	stolen
pamaj	stomach
ab'aj	stone
tak'alik	stood
t'uyulb'al	stool
tak'alem	stop
k'olib'al	storage
k'ayib'al	store
xkoyopa'	storm
uxe'al	story
kaxlan q'aq'	stove
suk'	straight
suk'	straightforward
q'oxom aqanaj	strain
jun wi	strange
jun wi	stranger
ub'e'al chak	strategy
jek'b'al uk'ya'	straw
kab'tukan	strawberry
soq'onem	streak
alaj b'inel ja'	stream
b'e	street
chuq'ab'	strength
q'i'tajem	stress
yuqutajem	stretch
utz kraj kb'an che	strict
uq'atexik b'e	strike
kolob'	string
ch'analem	strip
rilik che	strive
k'o uchuq'ab'	strong
b'anom k'ax che	struck
wokob'al	structure
chuq'ab'enik	struggle
ch'a'oj	struggle
ch'ojinik	struggle
ukojik chuq'ab'	struggle
ch'a'oj	struggling
k'ax uch'ab'exik	stubborn
ch'apalik	stuck
tijoxel	student
eta'manik	study
eta'manem	study
eta'manel	study
tijoxel	study
eta'manem	studying
jastaq	stuff
mayajib'al	stunning
maj kak'am wi	stupid
ub'antajik	style
ral ucholajil	subject
moch'kil	submission
upaqab'axik	submit
jastaq	substance
k'exwachib'al	substitute
nim uchak	subtle
k'o ch'akanem	succeed
b'anom chik	success
utz chik	successful
pacha'	such
pacha'	such as
utz'ub'ik	suck
xaq k'ate'	sudden
xaq k'ate	suddenly
rech k'axk'olil	suffer
k'axk'ol	suffering
k'iyal	sufficient
asukal	sugar
uya'ik ub'ixik	suggest
usaqil tzij	suggestion
atz'yaq	suit
atz'yaqinik	suit
xajb'al	suit
ukojik	suit
ub'an rech chech	suitable
eqab'al jastaq	suitcase
mulinem	sum
ch'utirinisanem	summary
saq'ij	summer
uwi'	summit
tukelal	sun
uwuq q'ij	sunday
saqij	sunny
b'enaq q'ij	sunset
uwachinem ri uwaq'ij	sunshine
je'lik	super
uwi'	superior
q'atunel	supervisor
wa rech b'enaq q'ij	supper
tzujunik	supply
tzujunem	supply
ujalik	supply
jastaq	supply
uya'ik jastaq	supply
toq'ab'al	support
tob'anik	support
tob'anem	support
toq'anik	support
kb'an che	suppose
wene'	supposed
qas utz	sure
uwi'	surface
upaqalib'al	surge
puskunanik	surgery
ukab' b'i'aj	surname
kuk'ulumaj	surprise
ksach uk'u'x	surprised
man kb'an ta chik	surrender
sutim rij	surrounding
ilawachinem	surveillance
uta'ik tzijonem	survey
usolik uxe'	survey
k'amb'ejanem	survey
uta'ik tzijonik	survey
k'aslem	survive
chomanem	suspect
junwi rilik	suspect
chomanik	suspect
junwi	suspect
umayab'axik	suspended
wene are b'anowinaq	suspicious
uk'olik na	sustain
tak'alib'al	sustainability
ruk'a'am rib'	sustainable
elaq'	swag
utijik	swallow
k'exoj	swap
usuk'ub'axik ub'ixik	swear
k'atanal	sweat
b'ukb'al ib'	sweater
umesik	sweep
ki'	sweet
utzalaj waram	sweet dreams
jiq'ol	sweet tooth
Nukaj	sweetheart
spojem	swell
spojem	swelling
muxanem	swim
muxanem	swimming
rilik ri pwaq	swing
xe'kopem	swing
xeko'p	swing
k'exonem	switch
jalk'atinem	switch
uk'exik	switch
sipojinaq	swollen
uche'l ij	sword
retal	symbol
katze'tzotik	sympathy
nab'anem	symptoms
wokchakub'al	system
mexa	table
uk'amik b'ik	tackle
retwokaj	tag
uje'	tail
uk'amik	take
uk'amik b'ik	take away
uchajixik rech	take care
uwa'lijik b'ik	take off
k'amom	taken
ch'awik	talk
tzijonem	talk
ch'awem	talk
tzijonik	talk
kel raq'	talkative
nim raqan	tall
uq'osixik	tap
tz'apib'al	tap
nak'b'al	tape
ajawatajik	target
kajawaxik	target
ajawatajem	target
rilik pa	target
chak	task
na'ik	taste
aq'	taste
ajawanem	taste
sib'alaj je' utijik	tasty
xink'utu	taught
té	tea
uk'utik	teach
ajtij	teacher
wokaj	team
upaxixik	tear
oq'ej	tears
ub'ixik tzij che	tease
kak'emeta'mab'al	technology
ware'aj	teeth
ub'ixik	tell
chab'ij chi wech	tell me
nab'ak'u'x	temper
q'aqtewal	temperature
tyox ja	temple
xa k'o uq'ijol	temporary
lajuj	ten
juchuy joq'o'	ten thousand
qajonel	tenant
uxekeb'axik	tend
ajawanem	tendency
maja'	tender
uq'ijol	tense
xb'in ib'	tension
k'ayib'al	tent
k'amb'ejanel	tentative
taqanem	term
taq taqanik	terms
k'ax rilik	terrible
sib'alaj je'lik	terrific
uwachulewil	territory
k'amb'ejanik	test
k'amb'ejanem	test
rilik yawab'	test
upajik rij eta'mab'al	test
woktz'ib'	text
chi uwach	than
tyox	thank
maltyox	thank you
Maltyox chech ri aweye'b'al are taq ktajin kaqil ri utaqik	Thank you for your patience while we investigate shipment
maltyox	thank you so much
sib'alaj maltyox	thank you very much
tyox	thanks
Maltyox chech ukojik we qakojkemchak	Thanks for using our app
che	that
are' ri'	that is
are' ri' utz	that's good
ri	the
elaq'	theft
ri	their
are'	them
upetib'al	theme
are' xuquje'	themselves
k'ate ri'	then
ub'antajik	theory
chla'	there
k'olik	there are
k'olik	there is
xa k'u cha'	therefore
taq wa'	these
are'	they
are'	they are
pim	thick
elaq'om	thief
a'	thigh
b'aq	thin
jastaq	thing
taq jastaq	things
uchomaxik	think
urox	third
kchaqij uchi'	thirsty
oxlajuj	thirteen
juwinaq lajuj	thirty
we	this
are wa'	this is
chi uwach wachretal	thorough
no'jimal	thoroughly
taq are'	those
pine'	though
b'anoj	thought
tzoqopital uchomaxik	thought
k'ulmatejem aq'anoq	thought
chomanem	thought
b'anik	thought
k'ulmatajik	thought
chomanik	thought
utatab'exik	thoughtful
chomab'al	thoughts
kaq'o' lajk'al	thousand
b'atz'	thread
ub'anik k'ax	threat
ub'ixik kb'an ch'ayanik	threaten
oxib'	three
majib'al	threshold
ki'kotemal	thrilled
uwa'lijisaxik uwach	thrive
qulaj	throat
rumal	through
are taq chi ronojel	throughout
uk'aqik	throw
chom uwi' q'ab'aj	thumb
xkoyopa'	thunder
Ukaj q'ij	Thursday
xa k'u cha'	thus
sip	tick
silob'wachaj	tide
utz unuk'maxik b'anom	tidy
jat'inik	tie
jat'inem	tie
uximik	tie
uyujik ib'	tie
b'alam	tiger
nitz'upam	tight
Tigrinya	Tigrinya
uq'ijol	time
kuxe'j rib'	timid
nitz'	tiny
tojb'al kaya kanoq	tip
pwaq kaya kanoq	tips
sutb'inb'al	tire
kosinaq	tired
kem	tissue
ub'i' ch'ob'oj	title
pa	to
b'anik	to be
uk'ilixik	toast
kamik	today
nitz' ak'al	toddler
uwi aqanaj	toes
junam	together
b'anb'al chuluj	toilet
b'italil	told
k'o uchijkil	tolerance
chijonem	tolerate
pix	tomato
chwe'q	tomorrow
aq'	tongue
we chaq'ab' kamik	tonight
xuquje'	too
xink'amo	took
chakub'al	tool
taq chakub'al	tools
ware	tooth
uwi'	top
ub'i' ch'ob'oj	topic
tzerinaq	torn
ub'anik k'ax	torture
chi ronojel	total
chapanem	touch
k'ax	tough
tour	tour
k'a pa	toward
pa	towards
su'b'al	towel
tinamit	town
b'anol k'ax	toxic
ujuch'ik	trace
q'ojom	track
k'ayij	trade
ajk'ay	trade
k'ayixik	trade
naq'tisam ub'anik	tradition
amaq'el	traditional
ub'inem ch'ich'	traffic
upaqanaj	trail
jurujik ch'ich'	train
tijoxik	training
uq'axb'al	trait
uxe'al	traits
uq'axexik	transfer
uq'axexik	transition
uq'axexik	translate
kq'alajin upam	transparent
uq'axexik	transport
ch'ich'	transportation
chapob'al	trap
mes	trash
xb'in ib'	trauma
b'yajem	travel
okib'al	tray
uch'ob'ik	treat
ukunab'alil	treatment
che'	tree
k'o uchuq'ab'	tremendous
qas k'o uch'a'ik	trend
rech uk'amb'ejaxik	trial
mayijab'al	trick
xib'ano	tried
relesaxik ch'ich'	trigger
tzoqopinik	trigger
tzoqopinem	trigger
relexasik t'iqom ch'ich'	trigger
uramixik	trim
b'yajem	trip
k'eyowal	trouble
taq lix	trousers
eq'anib'al ch'ich'	truck
QAS TZIJ	TRUE
kutz	trunk
rilik	trust
utz rilik	trust
uq'alb'al k'u'x	trust
q'alb'al k'u'xaj	trust
qas tzij	truth
kraj	try
Tsonga	Tsonga
q'axb'al jastaq	tube
ukab' q'ij	Tuesday
tojb'al chi ik' rech tijob'al	tuition
no's	turkey
Kurkuma	turmeric
usolkopixik	turn
kok	turtle
chajinel	tutor
kab'lajuj	twelve
juwinaq	twenty
juwinaq jun	twenty-one
Twi	Twi
kamul	twice
b'aq'atinem	twist
keb'	two
ub'antajik	type
junelik kb'anik	typical
itzel	ugly
uk'isb'al	ultimate
q'atb'al jab'	umbrella
man k'o ta ukowinem	unable
ch'utitat	uncle
man junam taj	unconscious
chi uxe' rech	under
chi uxe'	underneath
man qas ta kaya uq'ij	underrated
uch'ob'ik	understand
xinch'ob'o	understood
xa k'ut man jeta xub'ano	unfortunately
junamil	uniform
tukelal	unique
jujunal	unit
nim tijob'al	university
man eta'matal taj	unknown
ruk' we	unless
k'a pa	until
man qas ta kkojik	unusual
ajsik	up
at katchomanik	up to you
uk'ak'arisaxik	update
ub'anik utz che	update
k'ak'arisanem	update
uwa'ljisaxik uwach	upgrade
wa'lijisaxik	upgrade
uk'ak'arisaxik	upgrade
ub'anik utz che	upgrade
k'ak'arisanem	upgrade
pa uwi'	upon
k'ax una'om	upset
nim tinamit	urban
aninaqil rij	urge
q'aq' rij	urge
aninaq	urge
pa aninaqil	urge
aninaqil rij	urgent
oj	us
ukojik	use
kamul ukojik	use
uchokonsab'exik	use
chokonsab'exik	use
kojom	used
kachokonik	useful
man k'o ta kachokon wi	useless
qas kkojik	usual
amaq'el wi	usually
chokonsab'al	utility
q'ij rech uxlanb'al	vacation
taq t'isb'aq	vaccination
t'isb'aq	vaccine
kaxlan meseb'al	vacuum
pa b'e kak'oji' wi	vague
utz	valid
b'eya'	valley
nim upatan	valuable
ub'antajik	value
rajilal	value
man kuxe'j ta rib'	value
upatan	value
k'i ub'antajik	variety
k'i	various
ujalik uwach	vary
alaj xa'r	vase
nimarisam	vast
ichaj	vegetable
ichaj	vegetables
ch'ich'	vehicle
ajk'ay	vendor
itzel kunab'al	venom
ub'anik wi	venture
wokk'olib'al web'	venue
uk'amb'ejaxik	verify
k'extajem	versatile
okib'al	version
tak'alik	vertical
sib'alaj	very
utz la'	very good
uk'yab'al	vessel
b'e	via
silab'em	vibe
silab'em	vibes
knaq'tisax ukojik	vicious
b'anom k'ax che	victim
silob'wachib'al	video
rilik	view
alaj tinamit	village
b'anal k'ax	villain
ch'am joron	vinegar
ojer	vintage
ub'anik k'ax	violence
b'anal k'ax	violent
viral	viral
q'apoj	virgin
pa kematz'ib'	virtual
uchuq'ab'il	virtue
ilb'al	vision
usolixik	visit
ula'	visit
solinem	visit
visual	visual
qas are wi	vital
b'anom k'olem chi upam	vivid
choltzij	vocabulary
ch'ab'al	voice
man utz taj	void
uchuq'ab'	volume
man tojtal taj	volunteer
uxa'wachik	vomit
xa'oj	vomit
xab'ik	vomit
xa'wik	vomit
man k'o ta uchuq'ab'	vulnerable
chak'oj chi ik'	wage
ch'akoj chi ik'	wages
ximb'al	waist
reye'xik	wait
q'axel wa chi uwi' mexa	waiter
weye'j na	waiting
waranik	wake
k'astajem	wake up
b'inik	walk
b'inem	walk
wa'katik	walk
wa'katem	walk
wa'katem	walking
uwaxan	wall
k'olib'al pwaq	wallet
wa'katel pa taq b'e	wander
ajawatajem	wanna
ajawatajem	want
xwaj	wanted
ch'a'oj	war
k'olib'al atz'yaq	wardrobe
k'olib'al	warehouse
oyowarik	warm
yowajik	warm
oyowal	warm
yowajem	warm
umeq'saxik	warm
q'aq'	warm
uya'ik ub'ixik	warn
q'ilb'al	warning
ajch'oj	warrior
xb'e	was
uch'ajik	wash
tzaqik	waste
tzaqem	waste
ub'anik k'ax che	waste
mes	waste
rilik	watch
ja'	water
q'anq'oq'	watermelon
uq'e't polow	wave
b'e	way
oj	we
oj	we are
kojkowinik	we can
maj uchuq'ab'	weak
ri man kkowin ta che	weakness
q'inomal	wealth
utz	wealthy
uk'amik	wear
ktajin uk'amik	wearing
q'aq'tewal	weather
k'ulanem	wedding
Urox q'ij	Wednesday
q'ayes	weed
wuqq'ij	week
uk'isb'al q'ij rech ri wuq taq q'ij	weekend
upajik	weight
ra'lal	weight
pwaq	weight
jun wi	weird
utz apetik	welcome
utzwachil	welfare
Utz	Well
sib'alaj utz	well done
xinb'ek	went
xeb'ek	were
uqajb'al q'ij	west
ch'aqalik	wet
mataq'tami'	whale
jas uwach	what
jas uwach chi awij	what about you
jas ktajin kab'ano	what are you doing
jas ktajin kab'an chanim	what are you doing now
jas ktajin kab'an chanim	what are you doing right now
jas kab'ano	what do you do
jas kachakuj	what do you do for a living
jas kawaj kab'ij	what do you mean
jas kawaj	what do you want
jas xk'ulmatajik	what happened
jas uwach	what is
jas uwach wa'	what is this
jachike achak	what is your job
jas ab'i'	what is your name
jas kak'ulmatajik	what's up
jas ab'i'	what's your name
apas uwach	whatever
tirko	wheat
sutb'inb'al	wheel
janik'pa'	when
janipa' nuk'ut	whenever
jawije'	where
jawije' at k'o wi	where are you
jawije' katpe wi	where are you from
jawije' at k'o wi chanim	where are you now
jawije' katel wi	where do you live
jawije' at k'o wi	where is
ruk' rilik	whereas
je'	whether
chike	which
are taq	while
jasjatem	whisper
xulq'ab'em	whistle
saq	white
jachinaq	who
jachin at	who are you
jachinaq	who is
jachinaq	who is this
tz'aqat	whole
jachinaq	whom
jachin ajchoq'e	whose
jas che	why
jas che ja'i'	why not
itzel	wicked
nim	wide
malka'n ixoq	widow
uwach	width
ixoqilom	wife
rech juyub'	wild
kraj ub'anik	will
lal	will
uchanem	will
ajawanem	will
karaj kub'ano	willing
ch'akanem	win
kaqiq'	wind
wanta'n	window
kaqiq'	windy
vino	wine
uq'ijol jab'	winter
uq'axexik jun q'etal	wipe
alambre	wire
eta'manik	wisdom
aj no'j	wise
ajawanik	wish
ajawatajem	wish
ronojel ta b'a' utz xub'an chi awach	wish you all the best
ajitz	witch
ruk'	with
relesaxik	withdraw
elem b'ik	withdrawal
chi uwapan rech	within
man ruk' taj	without
k'olem	witness
k'olik	witness
kojol tzij	witness
rilik	witness
ilowinaq	witness
k'o reta'manem	witty
utiw	wolf
ixoq	woman
ixoqib'	women
xinch'akanik	won
man kb'an ta b'enam pa	won't
uta'ik	wonder
sib'alaj je'lik	wonderful
tz'alam	wood
rij chij	wool
tzij	word
taq tzij	words
patanixik	work
chakunem	work
uchakunem	work
upatan	work
chakunik	work
b'anik	work
ub'anik	work
ktajin kchakun apanoq	work out
ktajin kchakunik	working
uwachulew	world
xujut	worm
xink'am b'ik	worn
kmayowik	worried
mayowem	worry
sib'alaj k'ax	worse
q'ijilanem	worship
k'axk'ol	worst
k'o upatan	worth
qas tzij che are na	worth it
ya'tal che	worthy
kraj	would
sokotajem	wound
Wow	Wow
upisik	wrap
oyowal	wrath
ala's	wrist
tz'ib'anik	write
Tz'ib'aj waral	Write here
tz'ib'	writing
tz'ib'wuj	written
man utz taj	wrong
xintz'ib'aj	wrote
uwaja	yard
warik	yawn
k'ab'oj chi'aj	yawn
waram	yawn
uk'ab'ik chi'aj	yawn
Je'	Yeah
junab'	year
taq junab'	years
sipojisab'al	yeast
uraqik chi'aj	yell
q'an	yellow
Je'	Yes
se katijo	yes baby
je' loq'alaj	yes dear
je' loq'alaj	yes honey
je' nuloq'ob'al	yes my love
jela'	yes of course
je'	yes of course
iwir	yesterday
maja	yet
ajawatajem	yield
at	you
at	you are
ri at sib'alaj at je'lik	you are beautiful
at sib'alaj at je'lik	you are so beautiful
maj kub'ano	you are welcome
at ktkowinik	you can
At aweta'am	You know
xuquje' at	you too
maj kub'ano	you're welcome
ala	young
at	your
maj kub'ano	your welcome
at ri'	yourself
k'ajolal	youth
maj kub'ano	you’re welcome
sib'alaj utz	yummy
maj	zero
